player_id,username,age,gender,location,total_games_played,wins,losses,total_time_played_minutes,total_moves
7af307e4-351c-40fb-b49e-dedfae2bbc71,kwashington,43,Other,Portugal,80,1,79,1600,2080
c6aa75e0-1f84-4a58-999f-8bb0ef3eafe5,oanderson,19,Male,Qatar,7,4,3,301,434
398e03b2-be77-4ce4-9008-3e4aeb3b14b6,jgonzales,33,Male,Martinique,63,12,51,1134,2268
9641bbf8-c22e-4bae-b15d-888142f6f6ca,smithsteven,54,Other,Equatorial Guinea,67,26,41,1139,3953
91d519a9-ebd1-4338-bc37-c843c5bacf42,pnorris,28,Male,Brunei Darussalam,82,73,9,2870,3362
d5def1c0-369a-4498-a903-8dfd9a7f8555,usnyder,62,Other,Togo,26,3,23,416,1456
5c6ffbc6-4f26-46cc-aae9-10e1123fce66,melissabyrd,35,Female,Micronesia,26,2,24,598,2574
9ee2ae60-18a2-4e53-a2ac-f3a8a73f33cb,vbrown,63,Male,Costa Rica,93,32,61,2604,7626
117bfbb3-b28c-4826-a4cc-d40073553135,jenningsmiguel,54,Other,Somalia,41,34,7,738,1312
a0af44ef-b8f2-4aa6-b96d-ced93e4e0da2,zjacobson,31,Female,Czech Republic,20,0,20,680,1860
9227a168-9fa1-4889-a14e-043279e2c63c,pcollins,20,Other,Micronesia,44,14,30,1408,4268
6cfbc09e-7e8a-445d-80ad-64656876e4a8,jesse68,38,Male,Indonesia,96,61,35,2784,2688
fe05bd4c-0290-40b1-bc2d-53390aa707b8,ysparks,40,Female,British Virgin Islands,67,25,42,1273,6365
0a8c4c21-286a-4b66-9ca3-1f7385649ed7,amiller,30,Male,Lebanon,53,28,25,2385,2120
017586a5-fd81-4a5a-9ebd-05788f9ccd66,michele06,35,Male,Ghana,14,9,5,588,952
d72f5661-526e-47be-b49c-ab51b729ff7e,monicadavis,49,Female,Cook Islands,78,66,12,2964,3978
37e3aee2-89fa-411f-9e34-38ca92949595,dmooney,29,Male,United States Minor Outlying Islands,51,5,46,1581,4998
ea2772ce-c897-4b87-8058-92d6bd18438e,xcarr,59,Other,Turkey,88,48,40,1320,3960
f67d21c6-7496-40e5-837c-4816764f2898,nathan04,34,Male,Northern Mariana Islands,3,2,1,75,108
4a89c846-9eb5-4ea3-abb1-6272ced8fb0f,zrodriguez,59,Other,Central African Republic,9,7,2,297,189
33076764-62d0-4d8b-b8a7-1388f9857505,martinbradley,18,Male,Solomon Islands,36,30,6,1476,3348
b3fa4d2e-951e-4ca8-b812-83a15ea6e6b3,irwinmichael,26,Female,Myanmar,17,11,6,323,459
22324086-2d06-43cd-aaed-82212ae09f31,edwardstewart,46,Male,Venezuela,74,26,48,1332,7400
ee5aad5e-f0da-472c-a99b-f77ff644ea47,srichardson,26,Female,Namibia,39,11,28,897,2028
e86ac418-7530-467f-b9e7-b51bf0f929ac,xcruz,53,Male,Guyana,73,37,36,2701,2701
e91eb0cc-5be1-409c-92b0-35b66753a6e7,tyler44,19,Male,British Virgin Islands,15,14,1,405,1320
06396a52-a2f1-4949-a70c-44813deb1238,frederick88,37,Female,Korea,84,47,37,1428,6972
4c9af23f-7ca1-4638-95ef-39f9b1e5a17a,mendozapatricia,25,Female,Sierra Leone,52,51,1,1040,4108
2b3cd681-e782-4031-ac8e-5637a98c6b95,vroberson,31,Female,Philippines,68,0,68,1020,6256
3350b6dd-5c94-4bca-9586-5015e9733327,michael52,48,Other,United States of America,67,60,7,2144,3283
a14208fe-8b86-4f0c-8ad1-8f34902b56bf,jeremy61,34,Other,Iraq,77,29,48,3003,4543
88529e63-ea10-4964-9240-d1aa7942eee0,taylorseth,44,Other,Germany,88,86,2,1760,8008
b100d396-59c3-42b7-936d-4e81f781f2af,anthonymoody,25,Male,Faroe Islands,44,12,32,748,1584
7a25e855-10f7-4632-8408-d91af29420d2,kathryn96,22,Other,Micronesia,14,11,3,238,1022
24fcff14-c1f0-41a9-b2fa-d5f42e71da8f,robinjones,28,Other,Reunion,92,71,21,3404,6716
e9b86da6-8519-41b5-ad14-243d2fd6ad27,ilong,64,Other,Turkey,20,15,5,500,2000
e3502cd6-88ff-48a8-881a-537c3ba849f8,xgiles,60,Other,Cambodia,51,46,5,1785,5049
440025bb-2caa-4bbb-80d8-588acea40831,sean89,38,Male,Iraq,74,22,52,1332,2516
7f48b37f-656f-4e83-8ebe-fde45c58b604,jennifer41,26,Male,Somalia,19,7,12,684,418
7219a25a-7c85-41a4-909a-858062548868,scottgreen,47,Other,Papua New Guinea,83,35,48,3569,2407
3757390c-e3ab-4f34-a426-511e7d6efdf5,xpotter,28,Female,Uzbekistan,15,6,9,570,1470
13a5eb72-ca7a-49f0-9900-8efb3a94b6fa,bryan18,41,Other,United States Minor Outlying Islands,39,19,20,1443,3549
cfeadd72-a358-4728-8da1-e33177c5684c,steven12,51,Female,Cayman Islands,30,24,6,1290,1680
8abeb64d-cc0b-4c7d-9adb-5592579e54e1,vjenkins,49,Male,Kyrgyz Republic,20,9,11,640,560
aad0ce43-115b-43bd-9026-10ec69c3361c,lovejames,47,Other,Holy See (Vatican City State),77,23,54,2310,3157
3d0a81bd-973a-40e2-af13-ef898ada8574,jesserivas,21,Female,Trinidad and Tobago,55,2,53,1870,2255
ba25c19d-36e8-4bd2-be7c-19f534d67b66,iwoodard,38,Other,Malawi,8,8,0,304,344
11845325-745c-4ac8-8d17-ee6699a0578a,bryan54,63,Female,Tuvalu,58,40,18,2030,2900
f51cc9b9-4ea7-4cd3-bef7-7aabf833ce87,carsonbrent,52,Other,Turkey,94,5,89,2068,7990
8940cb7d-9401-4b2f-b67a-6c294345b235,deanna51,63,Other,Finland,32,25,7,736,2496
1abf045a-87d4-4474-995e-c858695a340d,sanchezmichelle,53,Male,Wallis and Futuna,35,33,2,1435,1400
0d012f7a-1cee-43df-a63d-1220dee7a4e6,fhoward,60,Male,Zambia,89,1,88,4005,8099
e675541b-0e7d-41f5-85b4-de66bdf13b47,audreythomas,59,Female,Germany,26,15,11,624,1066
33b2dd0f-0a61-4a84-ac81-c1a6d155baee,ljacobs,56,Male,Benin,61,1,60,1159,3965
f9bc973b-2c2e-4b04-a6fe-df7eb5a5c9a8,kennedytyler,39,Other,Greece,2,0,2,38,64
2471930b-68d5-4eac-8a62-301f6f9e6857,millerandrea,57,Female,El Salvador,16,15,1,336,432
400914ce-863e-4bfc-a37a-bddc7b14671b,arnoldcaroline,56,Female,Eritrea,94,58,36,2162,5922
27221eb8-1b79-4ecf-b88d-283db8c95176,daniel25,49,Female,Malta,44,24,20,1496,3828
d03ab51b-2412-470d-a280-420872f0babf,carmen78,21,Male,Germany,77,59,18,1848,2156
b6dcd0b2-f675-4d7a-91ad-baf5f7ddd7d9,ekemp,20,Female,Trinidad and Tobago,63,40,23,2646,3717
afd1f7c5-287c-4481-95d9-06d632b5d23c,michaelhudson,36,Other,Chad,90,1,89,4050,7470
465b64ef-a85a-43be-a390-d455975ddd01,jason10,33,Other,Iceland,43,34,9,946,860
b97308de-a9e5-4387-ae55-01c550921f09,tgonzalez,64,Male,Mauritania,54,7,47,1242,2160
a846b873-1ab2-4318-8085-b59560f5cdaf,floydjeremy,57,Other,Faroe Islands,54,45,9,1242,3456
2d32093c-3aa8-4faf-98c6-9ee4c3a7f060,dawnhardy,40,Male,Ukraine,21,13,8,399,1260
38feaf3e-6dcd-45ae-86c3-b993cf9127ab,iansampson,57,Other,Sudan,40,6,34,1040,1840
94fc8d3d-8f3c-4479-8682-17efc91266bf,joshuamartinez,52,Female,Congo,53,26,27,1643,2120
8d1020ad-b303-4fc5-8db3-2fce0a88cd2a,cameronturner,28,Female,Slovakia (Slovak Republic),62,25,37,1612,5518
0dc019ba-4777-4c07-98b7-1dd4f0fed49e,steven10,40,Male,Puerto Rico,14,6,8,350,1330
4b440236-e6e4-4738-b4c5-47fdd0c38851,barronyolanda,53,Other,Northern Mariana Islands,16,11,5,624,592
cf744611-3881-49e7-b2cb-cf9821366971,hchristensen,32,Other,Guyana,99,21,78,3168,9108
7cc48ee6-2049-4b18-9912-ff2b047be62d,unelson,52,Male,Fiji,44,29,15,924,1936
12aa7054-8c95-43da-b3d3-2643d192ed7e,kentdave,60,Female,Nicaragua,34,24,10,1292,2788
20a87b2c-3542-46c3-ab03-50d9055e2c58,garyzimmerman,54,Male,Spain,6,3,3,96,372
19e71620-efe4-4c93-b978-f6bfc34c15d2,pbautista,36,Female,Equatorial Guinea,6,4,2,132,510
bab008ff-5c8b-4851-94af-e04163e4d328,jenniferhumphrey,44,Female,Tokelau,79,31,48,2449,5846
4d071a98-f4fe-4e72-bb4b-86af598e8702,renee84,44,Other,Mexico,39,38,1,1053,3120
a4a7f786-6022-4f6c-a02b-c95560053395,tchase,39,Female,Andorra,45,43,2,1800,1395
74540ed9-d25d-41a0-b39a-93a8c74320da,rdickson,45,Other,Eritrea,100,95,5,4500,3700
0baa641e-88cd-4a7d-9d40-c3cb3723c694,courtneyhernandez,50,Other,Uzbekistan,79,53,26,1264,6320
0379e8e5-71a6-423b-989f-0afcb0a1a6b4,kyle85,54,Male,Cayman Islands,28,15,13,840,1176
1970fb00-4013-436b-8919-f27fb3ad9a2d,heather81,37,Female,Vanuatu,11,2,9,297,781
5173f4ec-9fb5-47e9-9c9a-8a74b6b97485,kevin04,25,Other,Saint Kitts and Nevis,85,7,78,3740,5440
642cf06a-0259-4694-b91c-e296954e3b89,nmosley,62,Female,China,53,33,20,2226,2650
a608c28b-7478-46cb-aabb-51f1ab4bf32d,mcdowelltyler,47,Other,Comoros,18,16,2,540,1170
a007f9f4-b1dd-4c49-80f0-2f7dd4f2d599,patriciahoover,48,Male,Eritrea,32,0,32,736,2432
dc7ed5f4-89c3-499b-8c62-e296f0715df8,valenciaalexander,31,Female,Ukraine,56,2,54,1680,5432
11693813-9bce-493a-a607-9119dd6f3bd2,sydneyhenry,24,Male,Afghanistan,81,56,25,1296,5427
6b949941-1734-4e8c-a4af-cff06d1b4ca4,wsingh,55,Male,Nauru,76,27,49,1444,2432
8f47de7f-866e-494d-924f-2a7cf02bfd99,benjamin89,50,Other,Thailand,75,73,2,2400,6600
e85bee41-425f-4e85-b2d3-d5dc5e2f0676,geraldfox,58,Male,Namibia,27,8,19,459,2322
f6233817-7ea5-4e58-9501-e58ec003ebc9,powellbriana,18,Other,Ecuador,4,2,2,148,144
12104144-be25-454f-8f0c-e5d43b15259c,chavezmichael,34,Male,Tokelau,66,11,55,1056,3168
5db0ee4f-f657-4a29-ae9b-e445f7013a2d,erin75,62,Female,Fiji,71,16,55,3195,5609
70cf346b-4059-4a81-afc2-fd7c5a2cf8cd,amber20,56,Male,Indonesia,11,5,6,198,704
8dedf90c-a6da-4bbd-9a38-4b516286a16f,jenniferharvey,25,Female,Ghana,10,3,7,280,650
b8d22972-3ac9-4280-815f-39e822e0b3b9,mshaw,61,Female,Israel,65,8,57,1040,6045
8fd0b0e4-8367-4d03-98ba-5b5cdd7824b1,nrodriguez,55,Female,Thailand,57,28,29,1653,2052
2812a791-2cd9-4e1b-a84b-50b3591e354e,laurie02,45,Other,British Virgin Islands,52,24,28,1612,2132
551fdacf-33b5-4393-8003-cb1deadba654,charlesbutler,20,Male,Korea,25,12,13,750,650
901bd07d-eedd-4962-972c-db0b72265738,johnsontravis,38,Other,United States Minor Outlying Islands,64,19,45,2304,3328
0d55ba4a-6a07-4a73-8430-6459a3f8bdfe,williscarolyn,21,Other,Vanuatu,11,6,5,275,341
c80da0a9-5bc3-4e18-a1f4-c057f2ec0d78,ellisonchristopher,43,Female,United States of America,42,30,12,1470,2436
882565aa-8e81-4cbc-bbfa-044d88589d0c,michael85,35,Male,Israel,25,8,17,425,925
589f1820-1ab4-497a-8b1f-89349041a242,kennetharroyo,42,Other,Syrian Arab Republic,52,20,32,1248,4576
d00a6d35-28f2-43b8-aa90-e7122caaf3db,schmidtjohn,27,Female,Germany,70,62,8,2870,3290
450d5efb-1186-41ce-9578-42d7d8be7e47,qmiller,51,Other,Belize,64,9,55,2560,2816
9378a81e-9644-4155-97ad-244ad6f82dbe,perezmaria,38,Female,Gabon,24,19,5,792,1320
055a2f6b-6bfe-4cfd-beaf-8b90ae7ab950,kendra38,38,Other,Western Sahara,73,14,59,1241,3796
1bb74222-f44b-4da0-aeb3-0fd3b9eb6144,tfaulkner,43,Male,Congo,19,4,15,570,418
cba3768f-2c83-4b9e-b905-5fd6e9291307,kristinanicholson,21,Male,Uganda,4,3,1,76,336
77fe3347-d94a-469c-b811-915e92e7a8de,gthompson,46,Female,Tuvalu,81,32,49,1701,3321
96e6cd11-449f-44f4-94ab-b3cbd1faa64e,whitney21,47,Other,Guam,23,6,17,989,1426
d6a3f46c-8457-4373-b7d4-4fbc15d74dd9,lauradavis,63,Female,Mongolia,35,34,1,1260,3430
3cb085ce-66e4-41bc-b0c4-902417c5a479,pecksamantha,54,Male,Norfolk Island,61,22,39,1037,2379
72c9ccd1-da83-45ee-b61b-c79383d470b0,stantongeorge,31,Male,Kiribati,83,78,5,3569,4731
3fac5c44-2373-4eb6-8459-da5e15d57919,aware,25,Male,Cambodia,18,12,6,342,1008
7f6045f7-9944-47f5-bf49-5db1128045e6,nunezkimberly,43,Male,Greenland,4,0,4,164,304
7ff28177-0f6c-49e8-a5d7-1e1bb2d549c2,joseph95,39,Other,Pakistan,36,13,23,684,1980
d3ea1630-1361-4d51-b2b2-7daaee215089,tstein,47,Female,French Southern Territories,41,11,30,615,2870
27887793-da27-4d08-a809-925c2c35ca72,jeffreyharris,45,Female,Israel,17,0,17,527,1547
0d31f0b4-f1f4-4b47-bcec-8a176244dea7,suzanne50,22,Other,Nauru,4,4,0,112,332
86f0d9d1-3575-4287-afa2-128ba243813a,calhounmary,24,Male,Switzerland,27,23,4,567,1647
755d374d-9cd6-4aa9-9be4-87a01b0e0fbf,ibrooks,52,Other,French Southern Territories,77,37,40,1848,4466
bd12f982-6b7d-475a-a3ef-38fad5321602,anthony97,63,Female,Northern Mariana Islands,91,13,78,3549,8736
b330828e-eb77-4623-ae99-5a3ddcfb7fbd,matthewpena,20,Male,Hong Kong,68,54,14,2584,2176
70695025-6f05-45cd-8421-ab03562f1dde,henryanthony,60,Other,Bahamas,44,6,38,968,2684
76285526-27ff-4c88-a04c-7efe4da2c0a1,tonya52,48,Male,Egypt,92,21,71,1564,4140
8e2e3006-9d5c-41f1-8d56-48130bd206df,vriggs,53,Female,Switzerland,98,70,28,2842,3234
6d58bd27-0570-424d-b8c7-d26a642fb0f5,peterssarah,42,Other,Reunion,22,4,18,396,2024
a8acff07-1f58-450a-a60d-11d4363d4ff1,jennifer55,30,Female,Cape Verde,92,54,38,2116,3404
e7229590-ceb9-498d-88f0-9dbc7d335dc0,stevenslynn,47,Other,Singapore,53,44,9,848,2968
a1517056-01a8-413c-a111-f6ece542aa47,owenskathleen,48,Other,Nicaragua,72,42,30,2952,5112
40d32622-41ad-40d3-8112-7dba79777a9d,bryantjoshua,55,Male,Senegal,29,12,17,551,1189
a3c394ba-1820-43b5-a372-10782d5f600b,davidfrazier,54,Other,France,51,35,16,2295,3927
9055dbf2-9260-4faa-8258-fa88f5bba2ee,kristine76,35,Other,United States of America,71,43,28,2414,4686
513ec392-4b07-4201-ad6a-82681ced8d53,thomastaylor,37,Female,Uruguay,78,30,48,1872,5928
55475676-a569-4661-b337-aedb74127d67,rbrown,54,Female,Libyan Arab Jamahiriya,9,0,9,342,882
73a4402b-f805-44a5-be69-559384a70654,michael25,65,Female,Kyrgyz Republic,68,23,45,2244,4080
31549c80-93ce-4017-9e25-d953f5a66ca9,erinlarsen,29,Male,Marshall Islands,100,52,48,4500,7700
adcc58a8-4007-4038-8c50-94d641197d8b,chamilton,48,Female,Cuba,2,0,2,56,152
2105869f-be93-481c-8a2e-5eb97569eb5b,kristinvaughan,41,Female,Czech Republic,95,49,46,2090,7315
da1eb344-1fb6-42fd-9aad-394c04f2d20f,scastillo,41,Other,El Salvador,71,8,63,2343,4544
689ff175-f6b5-43ad-9fe0-c7065010eb8a,ilane,38,Other,Suriname,15,10,5,480,1020
67ad636e-10e5-4fc6-867d-10537514159b,jonesclaudia,24,Male,Paraguay,46,15,31,1380,2162
1dbddc0d-f39f-42a3-a451-ab24a6f4489a,john98,64,Female,New Caledonia,72,28,44,1584,6120
36a856ac-9d0b-444b-993b-53e3391479e9,alexis92,65,Other,Wallis and Futuna,42,29,13,924,2520
bd7f8c3c-7df8-4fc4-8535-e3383f4b8518,avilajennifer,49,Other,Peru,63,63,0,1071,4977
95e96cae-f76e-4fe1-9829-ab15966ef45c,floressonia,28,Other,Barbados,64,27,37,2112,6272
08a2b7a1-9213-41dd-bb27-ba38787f685a,colleenbrady,21,Male,Guatemala,37,31,6,1517,1332
bf275ea0-4526-41f7-8a5f-361baacb4911,brian08,21,Male,Panama,39,14,25,1248,1560
f4e5e93d-3921-4db6-8563-385dcf54c38b,tiffanymaldonado,23,Other,Turkmenistan,82,72,10,2788,3034
13130b21-c269-49d2-a4b1-cb0d91fa4dda,ericbrown,35,Female,Kyrgyz Republic,69,58,11,2277,2277
657dc4c2-ed44-4057-bd25-4b7c030eba7a,elizabethrojas,30,Female,Malta,38,33,5,1026,2584
28db933e-e7eb-4608-bd2d-caff00a3630e,jamesjason,42,Other,Denmark,7,4,3,252,658
7384953f-376f-4eed-8388-511a4e175602,munozsusan,60,Other,Moldova,11,6,5,440,319
36d5e894-389c-40b4-8002-f8ce115671ef,kyle71,40,Other,Moldova,13,7,6,416,1209
89b5da08-fcf4-496b-9447-4b7817d74a52,stacywebb,61,Male,Bosnia and Herzegovina,9,8,1,342,450
1cd427d1-e799-450a-af98-fe2d0e42d340,jspencer,58,Other,Mozambique,21,20,1,651,840
1efc5270-edbe-44b6-b875-a9e31c6f9cf5,sarahjenkins,39,Other,United Arab Emirates,54,32,22,1998,1404
53b0ef11-ef56-4336-862f-ffbdbf9fee78,charles97,65,Other,Panama,97,23,74,4074,3492
4e0ffbb2-b141-4196-96e7-e3a7963eebe7,allison43,19,Female,Belize,14,6,8,252,1330
07a0eb74-c3ee-4581-a186-745526b6bc81,cookyvette,65,Male,Guyana,40,24,16,1360,2600
b20054cf-58f2-469a-8b24-9076be5f72fe,smithderek,55,Female,Uganda,33,13,20,660,1056
855e6c84-b2b1-48a3-9617-150b9447de07,bankskatherine,54,Female,Romania,63,5,58,2268,2331
944eebcf-50cb-4b2c-8dd4-9df3bc5069f1,adam37,43,Other,Pakistan,77,11,66,1540,7623
d03b9204-8859-45e9-bb7c-35c5a0982bd3,roberttaylor,18,Male,Liechtenstein,93,82,11,2697,8556
ad913330-b25c-4def-88fa-015973858d44,robert41,52,Other,Sri Lanka,93,6,87,4092,7161
c356e757-1240-47f9-b5b6-445d0b1bd5f4,jessica28,35,Female,Finland,89,54,35,3026,8366
49e2d83e-f4de-4b68-83c2-9115c9674500,jorgehansen,53,Female,Lao People's Democratic Republic,51,34,17,1989,3825
8ca20104-1887-4ed5-be45-aeec7ff4d141,gmccormick,61,Male,Taiwan,99,16,83,3762,5742
b188b442-452a-4501-b644-27a5bfbdea6c,cunninghamkelly,36,Male,Christmas Island,21,18,3,651,1197
94fff6f6-c796-45df-9401-6a4f8e68eea9,brucemccullough,28,Other,Greece,91,48,43,1547,8372
d6a40c90-097c-4ade-b357-8be88328a181,melissaphillips,30,Female,Saint Lucia,33,15,18,1485,1584
35d0979a-ff89-4d50-a226-8f4a9a517006,heather42,63,Other,Saint Lucia,92,37,55,3036,8188
8b1957d8-3bc7-4646-9c09-93bd943239aa,thompsonmatthew,30,Male,Greenland,14,11,3,210,686
df14a01e-5f14-4f2b-a011-434f92de86a9,jessica52,51,Female,Northern Mariana Islands,75,40,35,3150,2625
0a7f17a6-dad9-4d5d-8668-ad3ff57ffe05,william07,18,Male,Monaco,45,18,27,1170,3780
40eb60aa-aa09-44b2-8fd9-17d75c406457,ylin,48,Female,Tonga,60,10,50,1920,3540
06fcb93f-25a7-4cfb-9bef-4301ea21b341,jerry10,26,Male,Cyprus,80,3,77,1680,7760
d4ac9f2f-75ae-45cd-a8a2-293796b4f9d1,hartmarilyn,53,Female,Niue,64,28,36,2496,5248
0833bbcd-d307-4e93-a233-eeb1c52ea205,ann53,34,Female,Central African Republic,72,6,66,2376,3312
cfc7a141-09e9-4795-9fb7-2653212fd54c,fclark,20,Other,Ireland,42,18,24,1638,2142
24f1dc0d-4fd7-48b2-8716-c3522b31f6ab,rodneydelgado,48,Other,Solomon Islands,37,28,9,1110,3404
470f8b52-a61f-4a18-8a84-c2c6ec95e1b0,wowens,60,Other,Kuwait,43,20,23,1505,2752
51bca90c-5f63-4fa3-a3fa-5ba9a9ad8607,nathanmorrow,51,Other,Comoros,30,7,23,570,1830
7df7ed0b-8af5-42de-9fab-8c94dbe558c8,spencejames,30,Other,Ukraine,26,1,25,884,1404
ff71c7ee-56af-4c97-bddc-1e367a3a6489,fhardin,41,Female,Bermuda,34,2,32,612,2652
44550832-716d-48ac-bd2b-be613c2b3896,cody36,25,Other,Germany,22,12,10,858,1276
1de6d943-1064-4341-8961-5c6f0ebc7066,brodriguez,24,Other,Trinidad and Tobago,55,50,5,2310,2145
efb8e0bc-ca56-4678-a453-cc3e64f5b626,gperkins,61,Male,Antarctica (the territory South of 60 deg S),14,13,1,420,322
5e7c17cd-2df4-4a52-bae3-0e34c6842f0e,charleshodges,34,Male,Hong Kong,51,48,3,1836,3672
40aac37b-8393-4273-9eea-28dde2a14ee7,michelle46,52,Male,Mexico,92,91,1,3956,5336
8605236a-27fe-4544-a0b0-8252d5ca3ea8,nicholastaylor,22,Male,Myanmar,98,20,78,1666,7448
57a49328-78f3-4c07-b91a-958b972ed12f,osmith,26,Other,Australia,99,52,47,3960,8118
2d798433-bfa8-447f-8107-d9eb15b02105,martinezdavid,53,Other,Saint Kitts and Nevis,12,1,11,300,252
92d0efff-945b-49ad-9a46-72f9b101762b,goldenwilliam,38,Female,Poland,46,46,0,782,2392
f5102113-fe8f-4baf-a3a7-a7df0b94d0b0,danielmorgan,32,Other,Antarctica (the territory South of 60 deg S),72,45,27,2880,1872
ea9c0775-6c3e-4411-ab53-ea567a552347,jmorales,33,Female,New Zealand,58,44,14,1682,5278
8f55dc1a-f9db-4a50-9c87-bb25a716cecf,jose99,27,Male,United Kingdom,81,64,17,2106,4050
45a86cc3-d4e1-4e34-be4e-4b5ff512bc85,nicole56,58,Male,Timor-Leste,14,13,1,350,756
24e4bfcb-220e-473c-b27f-0e1bcf9663a2,thomasvanessa,53,Male,New Zealand,83,39,44,1328,6308
5e5cb32f-3635-4c4a-a1e3-a56f3de19f94,rarmstrong,62,Female,Guinea-Bissau,69,35,34,2484,6417
4d11531f-7ea1-467c-8df7-eb2d1174f856,ggordon,57,Other,Sri Lanka,28,7,21,1148,980
6fdb1654-5d18-4cd7-b122-749332405652,ibarrett,55,Other,Tokelau,75,30,45,1350,7050
9d8242c1-710d-4871-b6de-b7e3438f75a7,melissa46,53,Male,Australia,40,13,27,1160,1600
2b478094-d84a-4e63-85e5-eb8a0640da08,christineholland,25,Male,Morocco,81,18,63,2187,7776
bad07d08-9466-4826-88dc-7965d8a4c87b,orteganatalie,55,Female,American Samoa,91,1,90,3367,8372
9214171c-fcde-41b4-a4e1-762ff26112fc,thomas70,27,Male,Sao Tome and Principe,46,24,22,1058,1334
876d76bc-2e10-41d1-b7e3-d5c09a36988b,rlarson,52,Other,Jersey,44,10,34,1980,3960
cbb815be-5ab3-4028-ae18-33e34004d67c,smithdaniel,43,Female,Andorra,5,3,2,120,435
b4d13e43-527d-4f42-9cac-cce95ae9aa66,kyliewall,54,Male,Namibia,33,14,19,1386,1155
51091a35-aa2a-4917-ac30-15c47f722ffd,calvinmason,60,Female,Western Sahara,86,58,28,1892,3698
442a5cf2-4e79-43d7-aac7-11ad0c43b50a,daniel05,19,Other,Cuba,82,23,59,1476,1968
fe57ca9a-f8a8-4588-bf97-f994924a9884,fburton,25,Other,Bahrain,46,4,42,690,2392
2e0d551a-efaf-4bfa-820b-8889fb1c605e,kellydiaz,31,Male,Heard Island and McDonald Islands,85,63,22,1785,6375
6444c187-137b-4a94-b96b-ba449406f336,xallen,35,Male,Honduras,98,13,85,4214,7154
69c5de1e-cc76-45f4-b796-d0dd4340cea8,fritzchristopher,35,Male,Libyan Arab Jamahiriya,43,18,25,1677,3311
7378f581-2418-40df-b070-d83d76395d72,gomezgerald,28,Female,United States Minor Outlying Islands,27,18,9,513,999
22114dcb-26a8-45b4-a47f-34d159aa7a07,mejiajustin,49,Male,Marshall Islands,31,22,9,1085,2697
2e73089c-90b4-4755-bf9b-f0fe01166b85,odelgado,48,Female,Mali,43,18,25,1376,2451
5c6bd7f4-fb87-4281-81af-4365cfc233ae,williamarroyo,65,Other,Israel,93,45,48,2790,8370
1aaffd79-40da-4af5-8273-54bd7248ca13,xpratt,42,Other,Saint Barthelemy,3,1,2,87,249
d3621b36-20b7-47dc-92d5-97dfeb2d396a,tsnyder,24,Other,Puerto Rico,25,5,20,425,2500
84cb3674-f5f1-47c6-a6cb-85544150f926,elizabeth37,50,Other,Ethiopia,98,7,91,3920,7350
2cf46fa0-8aab-4780-8e2f-5e46a49896fc,igraham,44,Other,Maldives,59,11,48,1416,1534
9af69c80-62c1-4ff5-adc6-1d51471feb7f,cherylpeterson,31,Male,Australia,23,8,15,368,2139
dc406873-4416-4620-91a1-700e016b4a01,reyescurtis,63,Male,Cook Islands,12,7,5,336,636
fe5c3c1c-9e34-4476-90f2-302b65fe365b,blakemichael,19,Other,India,57,20,37,1653,4104
98cfc10c-60af-445c-abe5-02762e81f27d,katherinehanson,37,Male,Chad,79,53,26,1422,7110
5f4d1631-f5bb-4aa4-bc19-154cfecf9f8a,cmay,40,Male,Hungary,85,16,69,2550,2465
bce743d2-5c12-48f6-bbd5-caf79e9a5694,jimmy31,64,Other,Samoa,79,68,11,2528,7505
3cb4816b-fdc8-4ea4-8986-5a9dd2b39377,sparksdaniel,38,Other,Guam,95,57,38,3610,2470
55e8b8aa-b117-4a62-b389-fbc9c6b384f5,priceheidi,37,Male,Bermuda,20,15,5,480,680
bf68aa0f-c9e8-4aeb-a897-2b74c994e2f8,jennifermartinez,26,Other,Trinidad and Tobago,28,16,12,1176,728
4684cb81-65bd-4fc0-8bc0-a325c494ef13,lharris,34,Male,Indonesia,22,15,7,682,682
22d9d0d5-ebd9-4e51-9d1b-0422789237c9,barrettjamie,58,Female,Congo,18,15,3,504,1566
25878499-2ba9-46d4-b68e-114ae986fdfb,melissahuang,35,Other,Kenya,46,35,11,1656,1472
cc49732d-dcc1-439b-8fe5-21c98ef784d9,carpentermichelle,45,Female,Slovenia,22,7,15,946,2200
8e6c121e-842c-43f2-9f9e-763196e539b1,rachelsimmons,54,Female,Hong Kong,21,8,13,945,1659
cb6262c9-aac3-43c4-9568-5474fc175999,adam70,20,Other,Turkey,60,44,16,2400,5700
27f63687-6005-40e1-b06a-87bded793565,ztorres,46,Male,Heard Island and McDonald Islands,24,11,13,960,1512
855cc9b2-781e-4395-89b5-a192fa6f6bb3,ashley04,26,Female,Turks and Caicos Islands,85,32,53,1785,6545
5ad61c50-1f64-44f1-a0c0-af3527248bea,tbauer,44,Male,Djibouti,40,33,7,840,2080
bfa9165b-643d-40d5-bf84-3015f3eb41f9,erica47,24,Male,Hungary,36,36,0,1584,2952
ed28217e-4074-4cbd-a5dd-05bcba249425,xwilliams,34,Other,Ethiopia,91,3,88,1911,7280
4cd2315c-1cd3-4b47-9dea-a54a33c2cb88,robin42,33,Male,United States Minor Outlying Islands,21,16,5,630,462
005d45d2-227d-41b0-9578-ae05118c5a5b,browncody,38,Other,Congo,65,61,4,1820,5070
ecb493d3-6e0f-44c5-a035-4cbf7e736488,seanmontgomery,29,Male,Ukraine,6,5,1,192,294
7860bdf1-ec7e-4863-9019-7585ab61a10d,patriciamoreno,30,Male,Faroe Islands,85,75,10,2125,5270
6ec4dcdd-0818-45d6-bbb8-037325c4d943,kevin20,54,Other,Central African Republic,57,57,0,969,3420
c428b3f4-0302-4131-a55c-b73a7e2fcbd1,evansjames,36,Male,Uzbekistan,1,0,1,21,80
7d769458-7bed-42f5-b01c-1cd557cef4d2,lowechristian,51,Female,Cambodia,39,14,25,1131,2613
5e2297f1-20c3-444a-9270-bd115ab9292f,yhayes,62,Other,Congo,66,12,54,990,5610
1bcbc484-4c2a-4a8c-bf52-8ef0e3461181,eddiecordova,39,Other,Gambia,91,81,10,4095,4914
41ea2af9-5848-480a-abe0-492a0df1fc85,stevevalentine,62,Other,Kuwait,2,1,1,32,56
bf5e7741-7803-459d-9f10-2d16cb101939,jasonthomas,41,Female,Benin,65,59,6,1495,5070
a1498b58-aa1c-43f6-a87a-dbaf2e963d13,yfisher,58,Other,Turkey,1,0,1,28,75
3fc62892-fd27-4a3f-a9ba-219c251f5d71,zhangmelanie,21,Other,Nigeria,92,70,22,2392,7268
bdad2cee-fcd2-4336-9d55-9cf3e7167ffd,amyfinley,23,Male,Palestinian Territory,59,25,34,1062,2242
c7fbac40-03d2-4c63-a47a-8082a8d2c693,cooperjeremy,23,Female,Montenegro,13,1,12,481,1170
bd2e3cdb-292b-4ddf-b669-7a978eef9b1a,ashleeskinner,45,Male,Qatar,84,19,65,2352,7476
cfe74268-4474-436d-91b8-195042b15ebd,eric50,18,Male,Jersey,34,14,20,544,2482
e26230f8-8a56-424e-ae1b-62ae946810ce,zcollins,56,Male,Uganda,72,56,16,2592,4104
33ef530f-7529-4abc-ad93-52772b1cf9cd,timothy70,34,Other,Rwanda,1,0,1,32,96
4a87769c-0088-4e79-be24-1f7f59d8e547,cblevins,46,Female,Micronesia,24,10,14,600,744
6d0080e7-0d22-4df0-b40b-cfc415ffda10,xjohnson,62,Male,North Macedonia,65,9,56,1690,4160
376240ab-f146-4618-8195-5c6c1c32e294,christopher51,44,Other,Serbia,40,30,10,1320,880
9508f57d-7846-4424-9e22-7d8fe6b509b0,james80,24,Male,Guyana,81,73,8,3321,6723
6068806f-f5dd-49f7-ad30-d1a419090130,rodriguezelizabeth,36,Other,Cape Verde,65,62,3,1560,6305
35a15d18-5668-4556-8a1d-9a51f2c9f7d9,kimstephen,25,Male,Trinidad and Tobago,3,3,0,105,78
d6c276a6-0f7f-4cbf-8c69-eb5d2f28ea5c,kimberlyedwards,20,Other,Singapore,99,91,8,2772,5445
1d34d7bc-297c-49b1-b822-ce3d0dc64e8e,jessicataylor,65,Other,Togo,3,1,2,111,198
07baa23a-b7ac-4287-b958-8f617e5b153d,michellekirk,31,Male,Norfolk Island,16,3,13,448,1520
a34aeba6-69e8-4b1d-84b3-913846c21e25,along,41,Other,Singapore,34,29,5,884,2244
133c3862-65fc-41a1-84b3-60d0f5afcde4,suareznicole,20,Male,Finland,46,42,4,1564,1334
91287960-05ef-4c23-bb39-41fc2e9f2215,qberry,36,Female,Pakistan,15,12,3,390,450
56455c80-a9a2-400b-b68d-9064fba028cd,vjones,50,Female,South Africa,36,36,0,720,1872
11357b3a-3f5c-400f-b5d9-a8315bd75ffa,cynthiasmith,31,Other,Faroe Islands,50,1,49,1700,2700
0cd5e162-5ef7-4e50-b49f-9a6ddf9a2a92,odawson,21,Female,Turkmenistan,17,9,8,629,1479
5a94c6a8-09da-4528-9a36-e5ca000c38e0,wsmith,41,Other,Guam,64,63,1,1408,3648
3c1bddf3-d11b-46c6-86ea-7b30504db780,jamesmartin,38,Female,Malawi,50,11,39,2150,3800
7d4c391d-510c-46bb-bffd-bf349466d494,ashley06,51,Other,Heard Island and McDonald Islands,63,54,9,2835,4536
dfe72ba4-fbff-4a6a-8003-ff46392535c5,brian47,24,Male,Bolivia,46,37,9,736,1472
fb5d57b3-753e-4c9f-9b9a-9711d619471e,greenallen,24,Other,Saudi Arabia,23,3,20,920,667
6c2570ac-249d-4387-ac6e-e582db724f0a,sheacatherine,30,Other,Korea,36,27,9,1152,1584
50614382-b5f2-4372-bb5a-a649eaee2f74,ronald85,23,Female,Oman,65,49,16,1300,4810
81b113f0-e156-429e-96f7-ae0b18568a63,raymondcraig,32,Female,Lesotho,16,9,7,416,832
2e367efe-d52b-4c5d-bda8-9afb04b75f29,ssmith,31,Female,Albania,100,58,42,3600,2400
34a2623a-9cc3-46fe-b7ec-9392da75a017,jenniferpatterson,35,Female,Belarus,62,53,9,1054,1488
415b697c-ed80-42c6-ab8c-e1db8d4ef354,matthewadkins,27,Other,Botswana,73,71,2,2847,3504
b1bbf534-ed48-418e-a00e-14e174965647,csmith,60,Other,Netherlands,20,8,12,880,700
334db8ab-b4d4-476d-a56d-c095bbc96b7d,lisa08,56,Other,Belize,4,1,3,152,84
6ecddee9-8590-41b1-a18f-a8fd9240ffe4,kristenrowland,39,Male,Montenegro,39,17,22,741,2964
429bd575-c3b8-4267-a1bb-2688e70e5079,sandrawalker,31,Other,Reunion,90,23,67,1980,4320
1dd4beaf-f28a-41cc-be5f-7b84a1597f85,salazarrhonda,26,Other,Belgium,91,75,16,3185,5551
a4b2fe7e-d1b9-47e7-918f-ef9f4c68547c,josephlee,33,Other,Azerbaijan,18,8,10,720,1494
87f1c8fe-29fa-4510-8634-8574854f2f36,travis20,63,Female,French Southern Territories,76,3,73,1140,1976
66d34484-c6f1-47cb-a46b-9987e45d65ce,allison69,20,Other,Qatar,47,13,34,1316,1974
41702941-f4a9-4245-a2aa-126708b7c651,hernandeznicole,20,Female,Albania,51,35,16,2193,2142
d13d5907-162d-4377-a668-0bc89e4d5add,melissa56,48,Male,Turkey,95,58,37,4180,5605
2e260934-da95-4919-ad55-d44aedff7ef3,nrollins,43,Male,Slovakia (Slovak Republic),41,24,17,738,2788
852776d3-3cde-4cb4-92ba-7c3d711f1be1,sharvey,62,Male,Congo,82,8,74,2624,7134
205dc488-11e8-42bd-b102-5928c9f5cf18,mosstimothy,36,Female,United States Virgin Islands,85,31,54,1700,2890
84aabbac-9fa4-4f03-8ed7-4e1f043d07ba,michael41,41,Other,Greece,78,6,72,1248,4836
5858168d-8a7d-4025-b47b-c77944b79b3f,steven01,46,Female,Madagascar,26,8,18,442,806
9e4b40fc-fb06-4f16-bbb4-7fdfa0af574d,michael32,35,Female,Ecuador,2,1,1,50,120
73ada48e-e145-4cfe-ac3e-355741efb464,johnnystevens,60,Other,Guam,67,12,55,2747,2278
670dd611-7592-46be-bf37-7d1f45af7f55,mwebb,30,Other,Taiwan,63,47,16,2835,5733
f2cbfc82-b3e2-44c9-a7f3-1937ac51a3e0,rachel00,23,Female,Marshall Islands,68,2,66,1428,5644
3cc024be-2e01-469b-bb86-3fb16708db85,joshuaolson,64,Other,Paraguay,53,44,9,1431,3180
cd48e41a-a7f2-4444-a351-1e2114f6e33f,rogersronald,61,Male,Liberia,92,56,36,3864,6992
fae4d597-060a-4c31-8dc1-29f6d1489bfb,chungjohnny,18,Female,Gabon,57,46,11,2394,4845
8792d4db-083c-49e3-9600-6ddaaa67ba2f,michellegoodman,34,Female,French Southern Territories,95,37,58,3705,3895
7e6e8283-825d-4a98-83f4-f1283387e8aa,rodneyrios,45,Male,Paraguay,99,66,33,1881,9405
cdbe08a7-23e3-4403-999b-74dab981c81b,jonathonwagner,19,Other,United States Minor Outlying Islands,20,0,20,720,1440
4900dfac-878d-4cf7-adc5-aaca6d08335d,hubbardamanda,32,Male,Slovenia,96,1,95,4032,2880
1293a17a-14b8-4109-a7d8-313ddb5e9bd2,kevans,36,Male,Cameroon,91,42,49,3094,9009
5eaeb4af-867c-4efd-a09e-a7b709cca5b9,ellisdominique,26,Other,Madagascar,83,29,54,3237,6723
508b29f2-2ac2-4e2b-a72d-96efd266a808,smithcheryl,18,Female,Kuwait,99,80,19,2574,2772
cf134fd1-3472-49fb-8301-78f6caee76a9,burnspatrick,18,Other,Iceland,27,2,25,594,1080
61dcb69e-da5e-4b1b-a86e-c701f3371480,kobrien,56,Male,Montserrat,43,21,22,903,1763
abb2f26c-0946-4fff-ac17-b31d1e3a309f,epetty,27,Female,Serbia,34,30,4,1224,3162
af361e7a-1876-4902-93b1-b7fc91e11527,brownvictor,35,Female,South Georgia and the South Sandwich Islands,67,31,36,2345,3350
c03e6821-44a6-45dd-ba31-7a2a5a343fbf,kirk28,54,Female,Costa Rica,24,21,3,768,2304
bb21a75b-5c3f-4432-a5dc-23674d8f669a,westalan,18,Male,Papua New Guinea,22,22,0,946,1012
039dcdf9-fa98-4104-9a6a-45d63f4086bf,ericanicholson,65,Male,Trinidad and Tobago,47,4,43,1363,4042
f99bd305-4a7b-4907-8733-7f098b5935af,reedelijah,49,Male,Maldives,30,11,19,990,2430
4522411f-fe89-4a69-a760-6e6ffe13186e,lynn46,20,Other,Lebanon,88,76,12,1496,5720
be499270-9fe2-405d-8bb9-1127042338e5,lgalloway,33,Female,North Macedonia,56,15,41,2408,1680
4997dddb-8bb4-45c7-9ec8-0653ade192cc,mooremichael,58,Other,Oman,94,89,5,4042,7520
0cd8f290-7c06-4605-89aa-d31a65f1f721,zwatson,50,Male,Lithuania,97,64,33,3589,5529
2ba8fa0d-81dc-49a2-a9ba-5bb2560ae744,ssmith,34,Female,Comoros,69,22,47,2208,4830
79403e71-f6ec-47c8-bf0a-f91627ea59c5,xprice,57,Male,Malawi,44,7,37,1188,2288
cf9a5d8d-ad0c-42fe-9c74-1fa0fc7730c3,nicolekelley,34,Female,Colombia,33,33,0,1386,759
08d98f20-d18d-440d-8d05-26c499470518,rose29,18,Female,Saint Barthelemy,45,0,45,1395,2610
121c5721-644c-488f-8edc-0a3937c101b4,ucarr,20,Male,Senegal,66,17,49,1650,1386
6f76f731-3c85-4b70-b942-b05fcbb953d9,caseyyoung,45,Other,North Macedonia,97,71,26,3201,4850
fdb0c3c7-9c2d-4f80-9efa-8b479b4c966c,brenda72,52,Female,Venezuela,71,47,24,2911,2130
d8ab251b-cd55-49db-aaab-79f534f332b1,garzacrystal,42,Female,Algeria,69,66,3,2484,1932
c440fd5e-71c7-4c26-a7d3-95100c85e8b3,imcintosh,30,Female,India,71,61,10,1562,2201
c0264ed3-1c1b-4628-aecd-4751028bec35,dana89,33,Female,Belgium,38,3,35,684,3610
73bf1625-031d-420c-a5c8-257bdeb45562,william34,41,Female,Austria,84,43,41,1512,2268
00aaafd8-70d1-4f8b-a78c-866deb7bcb2a,hallchristopher,45,Male,Libyan Arab Jamahiriya,41,28,13,1640,820
a505ea8d-ad97-405e-aaa3-416d33aeba8b,jason33,46,Other,Brunei Darussalam,72,54,18,1368,5976
1f69d36f-b6a8-4444-9043-56460b63c583,reynoldslinda,52,Female,Burundi,60,48,12,2580,2520
4aa4da1a-909b-44e4-84c6-cc64699032ba,gail46,37,Male,Malta,3,2,1,75,183
b1b77429-6e86-4ec9-bd3d-c9f2180369ae,rbaker,21,Female,Palestinian Territory,14,9,5,378,826
aa83c925-a457-4dbc-8827-240683ee74f2,tballard,52,Other,Lesotho,20,19,1,820,1540
25289a76-fbb0-455f-b09e-2f84ac099d99,xdavis,64,Male,Samoa,56,38,18,1512,3024
72b1eb6f-04b2-4a39-af7f-a260b94269cd,crystalsmith,43,Female,Burkina Faso,61,45,16,2379,4514
5b9321d7-e0e5-4466-b5d5-ab7f94a5bcd0,luis15,19,Female,Mongolia,28,2,26,1120,644
51dd3c2d-5937-44e3-a752-7c1758890a76,michaelwilliams,32,Male,Latvia,42,9,33,1050,1638
059cb109-bf61-4c5e-910c-b7941420946e,ortizemily,49,Male,Estonia,62,35,27,1922,3534
d28f4c66-97ca-41d2-84ca-ed76e014a0ed,marygreen,52,Female,Algeria,74,6,68,3182,6438
5b068b1f-ae10-443e-a682-dde730b42e56,thomasdennis,53,Female,Israel,56,12,44,1288,5376
72a1dbb2-0f2a-4bc8-9473-4dd63239dca1,lopezsharon,19,Male,Iraq,72,71,1,2304,6336
87e57b1e-41ba-4279-8d10-1a1559782d8b,robingraham,52,Male,Saint Lucia,79,75,4,3555,5688
df5fbb43-8278-47a2-968f-48787f0e42e5,ehernandez,23,Other,Ghana,59,40,19,2655,3245
ebf62583-a1be-46ff-9bef-c3a065eea607,ncarlson,21,Female,Malaysia,3,3,0,63,279
052732dd-53cb-4914-a907-c55e5d758685,emma68,42,Female,Cook Islands,50,41,9,2150,1150
a75e4fa7-07b0-4517-9565-a6b3d31684a0,katherine71,25,Female,Tanzania,67,0,67,1541,6432
40caf578-e6bc-479c-87f9-9361bcd7afad,hodgesabigail,56,Other,Timor-Leste,32,28,4,1376,1088
49c51767-a462-4bd7-bb15-33999a479d83,urobinson,42,Other,Slovenia,48,5,43,1920,4032
4838a366-48ce-4bb4-9c69-7de63d3f9865,simpsonsarah,45,Male,Jordan,81,14,67,2916,3726
3439d4b8-e90c-4ddf-b24b-bb8cd910964e,umcgee,18,Other,Mauritania,61,0,61,1037,1220
717ecae8-8710-49da-8481-8c4bbd608c22,gutierrezbrian,31,Male,Cyprus,49,45,4,1323,4753
a988157a-3fd7-4383-b41f-ceefd43e97cf,vargasjimmy,31,Other,Syrian Arab Republic,40,11,29,840,3520
c8f56c32-0c3e-4b5f-8dcb-f3498547207b,rodriguezsarah,41,Other,Cayman Islands,32,22,10,864,1920
accd388a-f65e-4529-865b-a8c9f6ea0839,michelle12,58,Other,Lithuania,40,18,22,1000,2160
4be86b17-e79b-48cc-8c9d-9c621b57d092,wongmark,53,Male,Niue,35,19,16,525,1260
8a16dd70-c8fa-4376-b2fa-054f8a63c4d5,matthew98,35,Female,Guinea-Bissau,100,7,93,2700,4200
c45f3cc3-aa85-4cd6-9a0d-c69ddcbce2a1,melissahouston,29,Male,Czech Republic,22,16,6,858,748
4316e535-297a-44cb-a957-e5f70c764387,jasminewilliams,36,Female,Taiwan,15,2,13,465,1155
03c0adb2-1c01-4c19-b342-e5974776cf8c,debra96,46,Male,Holy See (Vatican City State),22,9,13,550,1100
a7611572-fe4e-428e-8386-d0245e1c4ef2,nguyenkara,21,Other,Bolivia,16,6,10,608,1440
1cd0c40f-308a-4067-92e5-711497bdd966,hectorsherman,60,Male,Holy See (Vatican City State),36,31,5,576,2340
86bbd1a1-34ff-48e9-b2d8-b77a31b495b3,williamsjudy,48,Female,Niger,6,6,0,108,540
cda97c12-36ff-4a53-b702-84ae692d6eac,crobinson,27,Other,Netherlands Antilles,74,64,10,1702,5920
fc97eabf-a8c3-4298-9fad-b3468260282b,patrick24,57,Other,Honduras,32,22,10,1088,3008
7ae4a07d-f52c-4cc5-8617-87b938fea368,jamesjacqueline,28,Female,Tajikistan,54,47,7,2214,4860
91fe9512-31ff-4d49-93a0-ae6ce940a92d,christianleonard,63,Female,Ghana,46,32,14,1058,920
614756b9-4816-4aaf-9c8b-b0c408c6ca50,dcampbell,63,Male,North Macedonia,72,29,43,2520,3600
609e2667-e8ff-4ca2-bf92-929a91787c7b,rebecca63,51,Other,Croatia,35,23,12,1575,3360
101c647f-1d6a-4d60-bea8-2811413b9663,joshualowery,37,Male,Northern Mariana Islands,82,61,21,3526,6314
93aff35f-7732-4ab2-b77c-c62d6c6e0081,nicholas98,20,Other,Tuvalu,44,13,31,1012,1056
ca5d004f-cbc8-4896-ab5e-f1a74b29669f,xgoodman,60,Male,Senegal,7,1,6,133,189
023d3770-2018-4901-bfe9-1c5af59f5636,vthompson,42,Other,Zimbabwe,23,9,14,483,920
baf49eb3-3804-41a4-8dd1-838358906bb5,carsonanthony,45,Male,Brunei Darussalam,68,39,29,2380,5236
a864b948-8a7d-4976-abc1-76fe8fcc098f,lori15,18,Other,Botswana,12,0,12,432,360
20f077cb-6d0b-4fc6-8d51-f2e2b2b938a8,jnorman,46,Other,Russian Federation,72,25,47,2664,4536
06d27d95-79c4-4804-a616-511724a53bcf,uking,20,Female,Marshall Islands,15,5,10,525,870
38fc6c2b-eeb0-4526-abf9-1db91f6ebb4c,bcurtis,52,Other,Belarus,74,14,60,2220,3996
5b7405bd-4f95-4205-bd65-283e5225fe7e,kathrynanderson,27,Male,Guadeloupe,31,29,2,527,1860
038d5e39-c431-4735-b4bd-7b558914848b,davenportann,39,Male,Mauritania,45,5,40,1170,1800
3086d825-9114-45db-bf06-59bb3c25fc31,jenniferrios,21,Female,Nauru,59,36,23,2065,3009
76e0b69b-343c-4b4f-bb85-eac1de830276,michellecortez,50,Female,Bangladesh,44,37,7,1980,4004
7a84fa77-d2c8-4039-b85a-7d4607aa21f5,kyle23,50,Other,South Africa,20,6,14,820,1560
98c3c457-5eda-451c-a252-106ec833c62a,kingmelissa,46,Other,Tanzania,72,56,16,1944,1512
530ec2c4-bae2-43bb-8d70-95ebc0e6ed0f,cynthiathompson,40,Female,Yemen,100,5,95,3600,7700
839aa0bf-8505-4c51-8c29-e973d3c22c6c,fspencer,44,Male,Algeria,70,67,3,2940,4830
2ec5ea7b-ae8e-43dd-af6f-1105441969a0,meghan55,51,Female,Sweden,35,3,32,840,2800
50296e6f-be19-40c9-a5fe-4e20ea061a20,simonjennifer,46,Male,Mexico,41,1,40,820,3444
804cac7a-4f54-4d8f-ba89-2eb7b11ee426,crystaltaylor,21,Male,Iceland,40,22,18,680,2320
29744127-23de-45e9-a982-f64429603ad7,lmurphy,22,Male,Timor-Leste,11,9,2,385,484
d09f7ba2-0755-462e-989c-f3bc929d6899,barnestravis,21,Other,New Caledonia,43,41,2,1677,1419
025a9db8-12ca-47c5-9c40-1b04400b4f93,victoria79,46,Male,Zimbabwe,51,50,1,867,2142
9c679bd7-bef6-4c30-81cf-bf89149888ce,karen68,40,Male,Egypt,6,5,1,216,582
6f6b7077-dabf-4f0f-bcea-5e00f5f73937,denisehebert,42,Other,Mongolia,25,3,22,875,1275
8d1e7c73-6615-457f-ba61-81b2d8ec5efc,robin56,42,Female,Slovakia (Slovak Republic),57,14,43,2109,4503
192f961c-48cf-480e-9a45-c452229da659,jmayer,23,Other,Slovakia (Slovak Republic),40,3,37,600,2600
da670c3d-5a38-4010-a320-6976581f3fdd,carlos52,53,Other,Solomon Islands,58,57,1,2262,1798
324bf304-71f8-4121-be97-c826aeceea57,qanderson,44,Female,Trinidad and Tobago,94,93,1,2162,1974
4c68a681-e147-45bf-9180-04dbedc368a6,psmith,46,Female,Madagascar,90,9,81,2430,7560
3dba2a05-04d6-4867-a3b9-3e6d42f8a535,victoriahamilton,56,Other,Azerbaijan,81,17,64,3483,2592
8976e15d-37e7-49f9-be06-13156ec922aa,bowmankimberly,60,Other,Sierra Leone,1,1,0,35,80
e884c18f-a6b3-4ee3-8e70-f1ff2d051c3a,kmiller,61,Other,Morocco,72,42,30,3096,3600
4738549a-0173-4ff2-96e1-74f340262534,kylebennett,24,Male,Tanzania,94,92,2,3948,8272
e22ca983-8959-4c6f-b314-e15a38507bbf,wendy02,47,Female,Andorra,57,45,12,1425,2223
aeece1ff-0762-4071-89c7-af4282e9a2c1,galexander,36,Other,Mayotte,91,20,71,2912,4459
01f247a0-1f3f-4923-818e-2fea6e2aabd7,kwilliams,18,Female,Cook Islands,95,83,12,2660,7695
855fa478-d70e-4d2b-8cbe-64c03a49d009,howerita,49,Other,Czech Republic,7,0,7,245,609
da60311a-ef48-4ae8-b6d3-168dd1c43901,jessicalucero,30,Male,Lesotho,18,13,5,576,846
2f3e9a56-8fa6-421e-962b-267c526a6ecf,mark11,38,Male,Cuba,74,55,19,1924,5994
102f310e-6181-4742-bc66-eab6568aac79,mjohnson,65,Other,Vietnam,79,25,54,3555,6557
9c9c6654-f2d2-4f94-a572-d1c664738b9e,eric01,57,Male,Falkland Islands (Malvinas),86,53,33,3354,7396
6a29cdca-13b3-4f20-ad82-3401c8154252,ccharles,62,Other,Congo,34,22,12,986,2176
277e5b49-ed3d-4f10-b19a-a77ac115be65,beth99,40,Male,Cuba,9,3,6,216,630
a8ab0af9-b85d-4538-9084-fdcf453315b8,carl55,65,Female,Guyana,32,23,9,1312,1664
d06b165d-dbd5-461f-af60-4c5aeebdd224,qbarrett,44,Female,Macao,29,2,27,725,1160
a8a89e67-0db6-4bac-a65a-67ed3424e346,snowwilliam,31,Male,Turks and Caicos Islands,61,39,22,1159,6100
c5c8a307-7d38-45dd-a3dc-3772d5980912,wbryant,41,Female,Israel,43,31,12,1204,1505
4029563a-4548-49ab-9f01-c1b0eb22bd08,walkerangel,33,Male,Bahrain,20,14,6,700,800
47eecd35-6c3a-444f-9734-11d92da89e90,fmoss,29,Female,Iran,36,18,18,1584,1260
b39e72d0-a0b3-4afa-ad9c-511718360fa4,christopher07,52,Female,Jamaica,66,6,60,2508,4950
7031ceb0-ec96-46ce-938f-667a04f112c2,tbaird,29,Female,India,29,0,29,638,1276
ca7cddcb-c38e-4d7c-8430-6ff944951de0,deborahwebb,29,Female,Spain,92,40,52,3680,3864
6e2667b5-45a6-4b15-8bb1-8f5f14b43336,ywhite,44,Other,Yemen,7,6,1,294,266
5c78a450-cd34-4b8e-b029-4e17d4590250,jamesjackson,32,Female,Ghana,85,44,41,2720,1955
1610ab92-fbc0-41ba-b391-6b6495a76753,dho,42,Female,Saint Martin,12,4,8,480,948
c08dcb1d-d30c-41b6-8cf4-1ec226fe6245,jesus31,49,Other,Guinea,60,56,4,1560,5400
9c0c2100-d6df-400b-a535-a0e6873b94ac,markhudson,32,Female,Djibouti,36,16,20,1008,2700
7e8b00b7-2732-486e-bf17-527fd2fdd51a,jeremy34,31,Other,Greenland,67,4,63,2412,4623
92bb625b-850d-4cd8-8e8a-15d4335928fb,danawang,64,Other,Panama,64,29,35,1408,5504
5d32da30-aa08-4f01-ab82-a860f50658d5,xortiz,54,Male,Bahrain,20,16,4,460,1920
f0ccac1e-3cb8-4cb8-82e1-5b23100d4ce2,watsonkaren,50,Male,Czech Republic,39,22,17,780,3120
64d2b73f-9de0-45e6-ab94-8037ec6b2efa,cdean,31,Other,Zambia,75,5,70,3150,2925
fbd706a6-2eee-4070-9c3c-4a384bc11739,troycohen,51,Male,Grenada,9,9,0,360,549
2cd2fd91-ead8-4cb9-a53d-785e6f21a5d7,nicholstravis,24,Male,Bouvet Island (Bouvetoya),60,16,44,1860,5520
d6bcc884-2d5b-4b31-ba0f-ac249a24648a,josephdawson,27,Other,Liechtenstein,58,39,19,2320,1798
dc0d8ab8-e09a-44a6-beed-1636d56c3a02,jessicamoore,56,Other,Montserrat,66,11,55,1452,5610
7bf8dfe8-b05c-4cdb-8cc3-1eb3a40adfd4,mbrown,54,Male,Faroe Islands,100,32,68,3100,2500
7dbc22f0-118f-45bb-b2e0-58d612391994,allenjared,31,Other,Cocos (Keeling) Islands,2,1,1,88,84
b1b8960b-6be2-4e4a-94ad-e0b0d405335a,calhouncindy,31,Male,Zambia,39,13,26,819,819
1457bb06-cc4d-4411-a46c-f3bb428bce3e,fmiller,39,Male,Iran,16,4,12,672,1120
cf3607bc-5111-4a26-8cb5-c2bf84faabd6,lisasmith,36,Other,Vanuatu,78,36,42,2496,6708
7d0cb6d8-4d16-47fe-acbb-f56244c69279,nicole61,31,Other,Cambodia,86,45,41,2580,2064
f2ed1cfc-0b5e-4abf-b6e8-d353316b677c,laura01,64,Female,Sierra Leone,16,5,11,448,1296
ab112321-38f0-4930-aaec-17d158ec6ef9,sarahsuarez,57,Other,Sudan,45,41,4,1575,2970
918b6def-b121-40a4-86b1-d11c8b53f215,icruz,36,Other,Saint Helena,19,11,8,798,1634
a95fc725-cf19-4bd1-9261-47373543343a,thomaspatel,29,Female,Belarus,11,2,9,187,1001
dc349bf2-c682-451f-b667-ce0944e01c92,gordonsamantha,33,Male,Moldova,43,28,15,774,2365
2d3d8b85-a2b2-446c-abbb-c187cf6e2652,cunninghamtrevor,29,Male,Gambia,44,17,27,1672,2992
65ddd497-b7c4-4244-bf12-e814a24350a0,edgarmoore,64,Female,Brazil,1,0,1,19,75
e9bcea6e-bcae-4abc-be38-7251f7597846,brucemichael,40,Other,Bahrain,76,74,2,2508,5700
f826fc53-a88d-403f-a266-30004c14afee,rpalmer,57,Other,Isle of Man,27,11,16,729,1350
edf24245-13b4-4d4e-a6d7-3f2d9d262c22,zhurst,51,Other,North Macedonia,54,29,25,1080,3996
b52df01a-50d6-40e7-a3b4-a8049162dfe1,smithjacqueline,29,Other,Vietnam,53,11,42,1431,4081
33aa54f6-34c7-4ec7-a2d5-751cc9e0baf8,hayneskeith,41,Other,Guinea-Bissau,24,2,22,504,528
193209ca-a33e-44c8-939a-ef2ec0448e89,maryguzman,58,Male,Grenada,77,13,64,1463,5621
09d203a7-7a6e-4477-9fbc-5e5c57e21f61,dana78,63,Female,Botswana,54,25,29,1836,5238
9aa8ae4d-b215-4e7d-8032-e5d85aaae03b,joseph44,20,Female,Barbados,64,35,29,1600,6272
16d453b1-a5ec-4047-879d-29bff2056afb,cwalters,56,Male,Mozambique,72,41,31,2232,5976
67c2d585-0da3-4192-bfd8-1107140c52cf,markjackson,62,Other,Japan,62,42,20,1178,1488
23c9b862-4eaf-487d-8bc4-249efe464e1e,ryan68,39,Male,Latvia,95,42,53,3230,8075
a30d9259-4139-491b-9d32-2a91d500c660,williamsjoseph,37,Male,Pitcairn Islands,2,0,2,56,150
49a060f5-0d8c-4902-9531-e2f818099155,michaelwarner,30,Male,Puerto Rico,99,68,31,2079,7029
70d0bc3c-645f-44f7-b8a3-8a50be424681,ortegaluke,54,Female,Lithuania,93,36,57,3720,3534
2af76117-7070-4cd4-a6b7-ea6574a0dd5a,jimmywilson,43,Female,Ireland,55,18,37,1045,4235
94d9b99d-9f0c-4999-a48e-996f4f93fddf,patricia33,40,Other,Lao People's Democratic Republic,78,75,3,3120,7644
b365d089-6a5a-4d77-9322-9dd41763e598,karengarcia,54,Female,Portugal,66,31,35,2508,3828
e450981a-de23-4f16-9ceb-4c92f7622c9c,jerrybrown,44,Male,Western Sahara,89,66,23,3916,5162
cc72ca77-52b9-4285-a297-786c223499e2,jasonlloyd,21,Other,Canada,51,16,35,1836,1683
aacd0e95-b805-41e8-963f-acb30a9f43d1,dhumphrey,40,Other,Niue,68,19,49,2040,3944
7e89c6d4-ea9b-4e28-b846-b2303d55251d,derrick72,40,Other,Chad,96,44,52,3936,5472
d2c05e84-c2ca-420b-8537-eba485b67ab5,emmatownsend,29,Female,Vietnam,29,9,20,493,2494
3bf2fe6b-78a2-4846-8608-c69479729e96,jodibrandt,54,Other,Botswana,77,5,72,1694,4235
e3697543-1d65-43ca-8c2f-7c72795d2e26,erik49,19,Other,Liberia,86,65,21,3182,8600
135a4bb8-9b6e-4453-9e25-ee93ceac8db8,danielle73,33,Female,Gambia,71,32,39,1278,3479
d72a28fd-6395-4e4c-9c25-f3210ed3b226,matthew96,23,Female,Hong Kong,16,8,8,624,464
7006c45a-52b4-4fc5-b3c9-67c9cb92ee43,ganderson,18,Other,Netherlands,38,24,14,1292,988
26e89c0f-5da6-4e97-9e14-c2ce5203154e,mendezdawn,63,Female,Isle of Man,58,15,43,1682,5452
7b43add8-c006-4397-bb80-89f2dba49285,alicia93,20,Other,Palau,28,16,12,1148,616
fc0d3f9f-a842-481f-90b3-2c0792d62ec8,macdonaldvictoria,35,Other,Libyan Arab Jamahiriya,68,31,37,2788,6392
b47bef79-6693-46fc-aa06-e1806811c263,lance33,52,Male,French Guiana,80,48,32,1840,4640
e1828d9b-bd8b-4f01-87a4-ef497bc15067,mcclurewilliam,31,Male,Yemen,89,41,48,2670,3026
1e69d9dd-f0b4-46da-9fe9-0dfe3f948057,vreed,64,Female,Hungary,68,10,58,2856,5372
018c3eda-488c-49a2-8d83-acf9e68bcebc,heather30,59,Other,Somalia,27,2,25,702,2592
fd9dac30-911f-48f1-ba65-179ba5760c37,catherine34,21,Female,Georgia,68,46,22,2176,3400
bce2550e-8f92-4dfd-952b-c3354b56eab0,shenderson,30,Male,Grenada,57,57,0,2451,2337
c9ca7475-97ab-40a3-ae8f-0811758dea83,wilsonbethany,40,Other,Armenia,40,37,3,1280,840
41b6f43c-577f-4f9e-abef-c94f8b240b40,denisecampbell,45,Male,Montserrat,21,17,4,441,1323
14a9d960-c15f-4dba-85c6-e3c9342afecf,michaelroth,54,Male,Afghanistan,6,5,1,126,552
9d381edd-c527-4392-8f1b-f867b9bb48fe,pkelley,18,Male,Guinea-Bissau,36,0,36,1440,3348
4ea4cb98-72dd-4088-b033-d1983b91904d,hernandezlouis,43,Other,Madagascar,60,49,11,2580,2280
043a6bd5-ad97-4e82-8dca-5acfe9f17e2a,hermantimothy,29,Female,Brazil,27,8,19,1215,1242
dcea7c89-be91-46a1-842e-2560e13b3737,scott53,65,Male,Belgium,57,37,20,1596,1539
39e9415b-9352-4cc1-a0d7-4b7463676f1d,andrew48,49,Female,Saint Vincent and the Grenadines,44,23,21,792,2948
2190be70-4983-4260-bbe0-cc85da59a3ad,buchananmatthew,33,Male,Hong Kong,92,52,40,1748,5428
cf133ab3-5315-44e3-9fe2-9e3fa47d3234,ffisher,31,Other,Liechtenstein,68,8,60,2720,5508
80807e0a-27a1-4718-9c31-f22fc36c7059,johnathan73,28,Male,Moldova,41,37,4,656,1476
ecc054f9-290f-4fb9-945d-b238743014c7,zjohns,36,Female,Mongolia,44,12,32,704,4224
bc199679-a589-4164-94cc-5b1484b38180,patricia69,42,Other,Sweden,99,82,17,3267,7128
437ae4fc-c354-4917-b023-56b65eb1ded1,jamie56,61,Female,Saudi Arabia,55,32,23,1925,4180
ebb5c9cc-934f-4f41-b563-8eb92e12bec6,stevennunez,24,Female,Tajikistan,14,11,3,518,364
ca919f43-a89e-4741-ae46-6e07032be198,timothystevens,42,Female,Cocos (Keeling) Islands,24,19,5,528,2112
e3122519-d922-49bb-b101-0dcaf47c1704,traci27,51,Male,Libyan Arab Jamahiriya,93,59,34,1767,8370
031cad8a-a5d7-49ea-96ca-41099d57de2a,kari98,44,Male,Vietnam,33,15,18,1320,693
5f0f8671-3339-4cf2-b9a5-42305f0cb3c3,xfuller,31,Female,Saint Martin,16,12,4,672,1424
04d63f98-3b55-424b-9dcd-eb4626c37558,john34,48,Male,Swaziland,88,18,70,2992,4840
be7da791-7e1a-4438-bc52-7b0823b095ce,dwall,22,Other,Swaziland,53,31,22,1908,4717
13262a9a-47ae-452c-a63b-1a9d88e598cc,janiceoliver,57,Female,Saint Kitts and Nevis,91,2,89,3913,4459
d2cacb6a-a4df-41d5-a589-75f667359f3b,jessicareyes,65,Female,Trinidad and Tobago,35,17,18,1155,2800
040f0ff3-e66e-4c1c-82e8-f262c7f2e3aa,campbellmichael,51,Other,Mongolia,77,19,58,2156,2541
6d55b85f-cb20-4ebe-8de8-61fc19c761cd,zbrown,41,Female,Gabon,19,17,2,551,608
27003aa6-2fb1-4caa-ab1a-eb3fc920d4e4,angela51,22,Male,United States Minor Outlying Islands,83,53,30,2905,1992
6e63e12e-7ce3-43ba-bf76-e71575851c4c,therrera,28,Male,Timor-Leste,78,1,77,1950,4914
f4c4f92b-d189-42f4-8e72-ffa9f53c6f8b,garrettwilliams,31,Other,El Salvador,31,10,21,1178,3038
bcff357d-7e61-46d2-a06e-eb349f33b35f,allisonrodriguez,22,Other,Eritrea,7,5,2,224,413
691b8e86-e549-4175-b409-d5b68b2adb8f,pmontes,32,Male,Peru,100,7,93,2800,5800
fe056ff2-88bb-4e9e-a58a-176e7f85f882,danaporter,51,Male,Swaziland,56,24,32,1960,2184
e7e964ce-9d5c-49ec-924a-15ee3d938d79,williamrichardson,44,Female,Liechtenstein,54,15,39,2268,1458
ac043850-03a6-47a3-96d8-0a48c86d8e1c,kathylarson,65,Male,Qatar,36,25,11,648,1404
114b01fe-c3dd-400c-b037-d958aee731a9,mbenjamin,26,Male,Switzerland,18,15,3,666,1674
e5d045b4-19a9-4cbe-8a2e-d83156cd150e,brian87,25,Female,Gibraltar,53,23,30,795,1749
e68255d4-1527-4584-abc6-695a6adc033b,twolfe,43,Other,Guernsey,2,2,0,84,176
c0dda9c2-73cc-4654-84f9-14024c0c1bd4,qchristian,62,Other,Eritrea,61,5,56,1220,2684
e54ce494-9f8c-48ee-87fd-c4175d38255b,richardmckee,18,Female,Bouvet Island (Bouvetoya),46,34,12,1656,3128
4e240f99-7dad-488d-ba19-d6a2f531976f,bestjackie,21,Female,Myanmar,37,0,37,1554,3404
d983e876-3c30-44d1-887c-aa22a5ef7173,lindsay89,39,Other,United Arab Emirates,95,37,58,2280,7030
722f965e-5795-4dd9-b312-bfc9ec30f2ef,richardschwartz,28,Male,Palau,10,6,4,450,760
45305668-0138-4e12-b15f-7830af63f027,osullivan,39,Male,Turks and Caicos Islands,42,24,18,1470,2478
ced86016-73bd-4d23-892f-a0ba9f260a37,kimberly75,51,Male,Taiwan,6,5,1,192,132
5dede91f-54f5-437b-a85c-aefb7fc3192d,floresmarcus,37,Male,Belize,99,26,73,3069,4455
9ec78e79-d848-42dc-8a9a-a6b8114a2ba4,ricky05,55,Female,Serbia,86,9,77,2924,3268
e29d6242-7992-4acf-9e41-bec53231f099,ronald46,57,Other,Georgia,90,22,68,3150,7290
74b00015-7320-4122-ae18-7286ae72b853,christiansoto,38,Male,Georgia,88,28,60,3784,8800
059a8a24-8689-4364-9efa-458a598cceaa,phayden,24,Male,Congo,97,9,88,4365,2425
6fdf2a40-68ed-448f-b70a-72c3e15d98e4,kshields,60,Female,Guadeloupe,87,27,60,2349,4437
5db48655-8a1d-4e40-8cf4-e09fc4758552,valdezgabriella,52,Female,Palau,38,5,33,1178,1102
14835c81-6045-400a-a959-25c6d90c0a39,johnnylopez,18,Female,Sweden,14,9,5,266,1022
8287d274-062b-4580-914f-13125539baeb,david02,58,Male,Moldova,58,5,53,1450,2436
2a5152eb-265a-4bce-bd76-e1d7ae181fd2,ejuarez,50,Other,Guatemala,37,34,3,1147,2775
4990fea4-43f0-46b0-ae50-b0a276bfe353,debra22,56,Male,Martinique,23,17,6,828,1909
7580fbbf-e629-4398-bebc-164f971b3f2f,sandrawatson,33,Male,Gabon,90,36,54,4050,4050
99271855-7cd0-4110-91fe-079405a1a435,loriaustin,37,Male,Micronesia,80,33,47,1280,3520
fce48e6e-00fa-4ff0-af8a-a845e416c514,nelsonrobert,19,Male,Monaco,1,1,0,44,86
5d5d9aa6-c33d-43bf-9f87-89b4606a4b4e,melissasharp,58,Other,Mayotte,8,5,3,320,528
3073d9b2-92b1-4898-aeae-8b2230adbd7d,monteswilliam,34,Other,Slovenia,90,23,67,3870,5040
5e3b115f-0aeb-45b7-8e28-fc78068bcc22,jeffreybrewer,33,Female,Slovenia,5,3,2,180,400
25e2785d-3968-4721-a8c3-9634d6e2fa5a,richardrichardson,51,Female,Angola,71,22,49,1704,1420
59a77eec-158d-4bb9-b30e-9fe95b3baa16,andrewcarpenter,53,Other,Switzerland,48,23,25,1344,3984
5011329e-cde1-44db-bcae-70cc342e8613,dawn86,44,Female,Israel,4,1,3,164,140
4d9c357f-3d7a-424d-b503-578e4d8de50e,comptonpaul,57,Male,Vietnam,39,18,21,858,1443
92da120f-b8ee-4b55-99ed-ce81de1fbd94,mejiacynthia,21,Other,Iran,46,4,42,2024,3910
44f73725-58ac-4525-bbdf-8fb22d3abf39,rgomez,45,Female,Zambia,53,39,14,2279,1855
9dd92e43-9546-4b6c-92b0-3ee063dc869a,amy04,22,Female,Malaysia,9,6,3,315,504
9ca3d87b-ee63-4a1b-8fe6-5f80a6cd8eee,hannahmitchell,62,Female,Australia,95,76,19,2280,2280
50afeba6-62ed-4bab-8c14-c297a24d76df,leenathan,20,Other,Senegal,37,19,18,1184,3626
f5370af5-6ac9-4a13-8575-2a4616ac48c1,scotttyler,61,Male,Saint Pierre and Miquelon,94,52,42,2914,4324
1a59f957-0659-486b-830d-af4791e3a14c,katherine88,60,Other,Kyrgyz Republic,11,1,10,429,1067
39901633-7d42-4efc-991b-8c2fc927a5ba,raykatherine,65,Male,Comoros,62,33,29,2666,3782
6289ba74-64a6-401a-b66f-20b2b3863c1a,dylanmartin,54,Female,Nicaragua,35,16,19,525,2345
9df26963-49e3-4bed-9efa-f6783a554130,jordan13,40,Male,Niue,49,29,20,1029,3969
4cdca6d5-7d9f-40b4-b447-3669c56ac864,ysmith,45,Female,Zambia,21,8,13,882,840
1ade3fa3-390f-4222-9689-710f1dc0356d,utapia,58,Other,Vietnam,80,21,59,1680,2880
c8bf83d2-e5c9-4af7-8761-b8d37a916fc9,ysilva,51,Other,Guam,50,7,43,2200,2700
3d57eb1c-9ede-4f8d-8bd7-b712cea02ebd,gallowaydeborah,27,Other,Norway,39,26,13,819,3549
c0224bec-4cc9-426a-bf3d-36a486084e15,emily81,35,Female,Croatia,5,5,0,205,285
ef8f9c2d-f621-4460-be7d-842100fb634c,rgray,28,Male,Finland,14,5,9,616,1064
8a15770c-0dd3-4fb0-aae3-15a7f04df611,hillbonnie,50,Female,Iran,1,0,1,44,74
050c2b07-35da-4730-97a1-16db4b8ad1ad,ybecker,21,Other,Togo,21,9,12,357,1491
92ff08df-b696-4e16-b3f1-fde872d141c1,fuentessue,29,Female,New Zealand,49,47,2,931,4851
5bd10e61-9d6a-4312-b064-df103ffa48e0,stephaniehester,50,Female,Morocco,12,4,8,480,924
69b4407c-4eb1-4568-8591-b6bbf5a89c16,andrewwest,43,Other,Greenland,62,33,29,2728,3286
27cc4e23-86ec-4d22-9620-6dae00768494,brianna58,42,Other,Guatemala,37,6,31,1110,2664
6d34db1e-5ef3-404c-969c-16a859603466,annahoward,56,Male,Gibraltar,35,17,18,1155,3325
16f5067a-7695-406a-80b0-1aae531131f8,ikennedy,47,Male,Montserrat,82,17,65,2132,4018
75adb1fb-b5a5-41d6-9ac4-1889dd8a29f1,zwhite,65,Male,Honduras,91,5,86,3003,4368
bf87126d-90cf-4e64-bee4-2836e67ce45c,elizabeth64,41,Female,Saint Barthelemy,89,39,50,1869,4984
29ea22b2-d70d-4a68-b976-fd7dae6ca051,xjohnson,44,Female,Panama,55,20,35,2255,3080
94596f1f-f09d-4ab3-8b0c-01d35d466dee,ibrock,49,Male,Barbados,49,10,39,1274,4508
ac9ea056-4272-4d72-831f-a78a6a5bcc86,jennifer62,26,Female,Egypt,17,6,11,544,595
b5188420-9cd9-425f-8650-388fba4e2eb6,hernandezlonnie,41,Male,Singapore,77,14,63,1848,2233
3d954103-d43d-4a3d-bfec-1963424130ae,zdiaz,44,Male,Gabon,43,42,1,903,1591
127898f9-03e6-4fb3-acfb-d7fe87209c25,ibeard,54,Male,Brunei Darussalam,40,17,23,1760,840
2aec1a5a-0e5f-4407-87e8-b3d3981c5cee,kelly04,29,Male,Bulgaria,33,1,32,726,2673
4cdf85d8-008e-454d-93a9-ab54b5cee6b0,griffingary,52,Male,Christmas Island,26,13,13,858,1716
968990aa-9c1e-4ed1-b31a-bf32aacda316,shawbryan,36,Male,Zimbabwe,67,48,19,2814,2412
1119c010-a848-4818-8fdd-6d401c934860,ronald44,60,Male,Senegal,49,34,15,2058,3479
e640b43e-4076-43c7-a312-54ad2d661109,charlesmedina,63,Other,Namibia,89,76,13,1424,7832
e8ae2c04-87fb-46a4-86e8-d1be2d5afcec,fischeredward,55,Other,Somalia,21,10,11,651,1092
0cf2f8c3-0391-47a0-92db-a285e48a1cee,hallelizabeth,30,Male,Faroe Islands,87,27,60,2871,8004
ac2fdbbf-70d2-4021-8dea-a6f7241ce395,zburch,41,Female,El Salvador,20,1,19,880,1000
cda5a264-7159-4858-b3a4-26bdaad51ce3,brenda89,47,Other,Bangladesh,28,7,21,896,2800
25359dbf-6115-4c0b-ad0d-6ef353235643,lawrencemichael,43,Male,Japan,62,14,48,1798,1922
8cff8c8f-c7d9-4e58-8ed5-03fdcb6b0b97,margaretunderwood,27,Male,Burundi,19,19,0,475,1482
e752e539-c9ed-4fba-9358-37a1c5302eed,susansmith,46,Other,Uruguay,88,44,44,3256,1936
ff47771b-3d3b-402f-8abd-eb41aaf99049,rparker,18,Other,Liberia,97,92,5,1552,2328
6a4c65f3-d359-478b-8c17-0e7a5ae35fc4,qsmith,22,Other,Antigua and Barbuda,63,55,8,2646,2961
30f8140e-e4c7-4781-b082-5e201162a8ec,carlbeasley,54,Male,Venezuela,11,7,4,418,704
5ace54dd-63cc-4903-8e49-08b01ff9f658,amurray,25,Female,Holy See (Vatican City State),56,16,40,2464,3696
92289add-af04-4ba4-8ae8-dfefdf98ecbb,davidbaker,29,Female,Brazil,6,4,2,198,234
fe27f16f-3cb5-4854-b6fc-42b750b3beb5,williamsheather,27,Female,United States of America,20,10,10,580,400
b1f09b6a-a837-4e37-b65f-902ff587638f,paul54,23,Female,Montserrat,57,47,10,1368,4902
505effb5-c7bc-4988-b7b5-de12191c0a56,lori59,30,Female,Palestinian Territory,86,37,49,2150,5676
43410a73-bc91-4a1b-9349-06b12a4fcd79,qhunter,65,Female,Russian Federation,84,22,62,2772,3696
4556d8f1-e4dd-4b55-bfac-742179324d7d,jessica73,55,Female,Bhutan,75,37,38,2400,2400
02ea22ae-8258-4388-9f64-529264854e33,jason27,33,Female,Kiribati,39,25,14,1092,1209
04a7ba89-6705-4293-827a-595ad6cfcf8e,lreese,45,Other,Macao,10,4,6,390,920
e344cd5a-0191-4886-ae95-6bb94cf412bb,thawkins,48,Male,Tonga,26,26,0,676,1534
b5c72d3a-2682-4425-9dc7-c91ada1e5665,ugillespie,30,Other,Micronesia,46,18,28,1288,3220
cd0727c5-e3a0-4443-81f9-3a1850a0cd22,matthewmason,19,Male,Egypt,97,13,84,1843,9215
05b5210f-78ea-4309-9a58-ee975e3e7351,jonathanclark,46,Female,Colombia,38,25,13,1406,3648
82fcb6eb-a480-47b6-935e-47d51b47878c,ronniebond,43,Female,Kuwait,99,36,63,2277,2871
f6b1a0e6-6975-49af-9af2-67bbba9059f8,maria40,36,Other,British Virgin Islands,48,2,46,1488,4704
1e7002de-61a1-4c9a-8da4-11eafa371956,bridgeskristen,22,Male,Germany,95,66,29,2565,9405
91e98ccc-d042-49d4-9dd1-06095640c626,crosbylaura,49,Male,Equatorial Guinea,89,42,47,1780,8366
49d3f9e7-1af2-4bfe-b650-cf04797d3201,robert97,54,Other,Malaysia,99,42,57,2574,3762
4d8a25b6-d352-4039-a85a-d14b6f02fd45,ellissarah,38,Other,Lao People's Democratic Republic,17,16,1,629,850
6b3d5116-3619-4230-8162-7eb9be20bd69,aschmidt,44,Male,Liberia,80,8,72,1920,3840
24adead7-6d73-49cb-8b73-57e675345c7b,frogers,35,Other,Falkland Islands (Malvinas),51,25,26,1581,2907
7b9ec062-1308-470f-a25f-7ed560a42f8c,tarias,31,Male,Congo,57,50,7,1311,2109
24058d79-c7b2-40b3-b0f8-b2f282a9c660,jennifer11,48,Male,Uganda,23,14,9,483,1081
5f5542ff-37ac-4b3f-961d-f7f57f00e2d7,timothygregory,62,Female,Djibouti,28,3,25,504,2296
d043cf67-f722-45f0-a472-9b6f0a79c2a6,gmiller,18,Male,Mauritania,22,18,4,638,1540
70a42b61-76f4-4767-a17e-6c17c463df41,delacruzsteven,42,Female,Malta,54,39,15,1998,3942
1d418c4e-8a12-420f-b955-c0c20e941b4b,swalls,65,Female,Bouvet Island (Bouvetoya),52,42,10,988,4628
fc7859e9-b915-4e6b-b7bb-16be961fa3e0,lwilkerson,33,Other,Pakistan,47,25,22,846,4183
ecec49ce-7a74-4014-970c-d7cd3c619d89,sonya96,61,Male,Philippines,23,16,7,483,897
09c66c2c-4c10-402d-9e34-2b5a2ee1c01d,eddie76,63,Female,Netherlands Antilles,60,9,51,2160,2040
040f87d4-5974-4265-977a-2cf3b181a48f,wendy54,38,Male,Romania,70,53,17,2590,3010
76f7ea6b-ebaf-4407-b391-73b4aa1ff9f4,browntimothy,39,Female,Cook Islands,30,9,21,630,1800
84094c69-5c4a-4b93-83c6-c958023b77e7,stephen12,59,Other,Micronesia,94,81,13,2068,3290
837821c4-abe4-4a4e-b8ee-f72fd2ec4abb,christina69,62,Other,Cocos (Keeling) Islands,53,37,16,1696,4028
37d60f00-f04a-4174-9603-abfc1258664f,estanton,22,Female,Antarctica (the territory South of 60 deg S),10,9,1,420,400
5150aedb-35e9-40fc-ab5f-5858cda93fa3,grantchoi,45,Female,Cocos (Keeling) Islands,36,16,20,720,2664
13804fbe-031d-4489-a1ce-6d27e6b99cbb,john85,50,Other,Bulgaria,10,3,7,200,660
80dcd6cf-83c4-4769-b602-288b2f689bd4,crossrobert,19,Male,Bosnia and Herzegovina,82,23,59,1558,4264
3b51ce9b-2a7a-4461-ae15-d47070dbeddd,xpollard,27,Male,France,41,35,6,779,2296
8dac47c2-2888-455e-9d73-230f5bb4cefb,mendozaaudrey,63,Male,Kyrgyz Republic,77,53,24,2464,6083
5decf4f7-81f4-4605-980a-1ea1465b89ad,callahansteven,38,Female,Mauritania,54,40,14,1944,2754
fbd1d687-5c5e-4df3-bb29-4900c90cc8af,maryhicks,25,Male,Palau,55,54,1,1485,1595
f6dd4df7-74f5-4af0-a788-2803b431d0a4,janetrobinson,40,Other,Uganda,87,6,81,2958,2523
d938dbc2-6b4b-4958-82b6-f5d36d81e0fe,hreid,27,Other,Jersey,25,12,13,450,1775
1e23f849-e158-45ee-9561-c6cbf0f638c4,jevans,23,Other,Jordan,67,14,53,2010,5762
73c1f175-9154-48e0-ba4b-3cb79df743d3,cpalmer,40,Female,Martinique,44,16,28,1892,3652
bd1402c5-f9b8-435b-b99f-658e155879d6,owenssusan,30,Other,Ireland,41,11,30,1066,2829
e5ac27bc-6c7a-430a-9bf2-bfca110c24eb,michaelberry,57,Other,Suriname,75,29,46,1725,5100
c8dbf27f-4d14-4d62-a863-f4cbb83da611,nicole30,44,Female,Papua New Guinea,10,10,0,350,770
14d47e41-3aa6-4aff-9623-8efe128d29f9,petersonrobert,54,Other,Israel,30,29,1,480,2010
38219856-2ef4-46cd-b049-4bbb3f1b976e,johnstonvicki,29,Male,Bermuda,81,29,52,1377,7290
856024e5-fd89-4253-9b76-5ef5ee0110aa,whitemichael,44,Other,Netherlands,59,49,10,1888,3127
ffad2020-92df-4ee1-be04-5ccbff171cfa,zoneill,47,Female,Chile,30,27,3,570,780
ee7aa301-14b2-4e9f-8c06-e98fe2009440,robertclark,33,Male,Suriname,4,4,0,144,228
9887f944-c377-42cb-9f46-f42fc62b8543,davidboyer,30,Female,Tokelau,5,4,1,200,310
5f59ef29-e335-4c0f-9176-e8c2e8cdfa33,taylor01,55,Male,Israel,17,8,9,663,731
028ae8d3-439f-48e2-acf9-6014c5b04bc5,erik92,35,Other,Iraq,26,0,26,832,598
a71b40cf-6b37-4608-983a-76c43ea47883,nancynash,44,Male,Paraguay,100,68,32,3200,4100
858f2cbd-b906-455e-a203-0cfaf242ddcf,michael65,19,Other,South Georgia and the South Sandwich Islands,87,30,57,1740,5046
fadb15c3-0724-444c-8660-aacbba38a43d,michaelwilliams,65,Female,Gabon,73,54,19,2701,5037
7152ce97-f210-47a2-b4bd-6f74606b5fa9,qharvey,38,Male,Russian Federation,15,3,12,345,510
87279609-84e6-4201-ad2a-5b530ad3c4d6,carrie32,34,Male,Nepal,46,40,6,1564,3174
3814275d-3a8d-47af-ba5d-1aad9fa4b8d3,kwest,49,Other,Iceland,16,0,16,352,1008
e17f5a87-c561-4579-b748-b6f8e368b0ee,flemingtanya,58,Male,Tokelau,23,0,23,506,644
7e1ff99e-d848-408c-9f91-3f8cb032d3ff,clarkdeborah,30,Male,Ireland,26,23,3,884,1404
1d5dff09-bb29-4f8c-b58d-5baa366c9f10,qross,25,Male,Iraq,24,23,1,960,2352
093adcf4-06a4-4d5b-9ed6-e0db4bf1b7ea,adamsbryan,38,Other,Micronesia,97,7,90,1455,8536
738fe908-bad6-4b88-8f74-be07e30fb47e,stewartjamie,20,Other,Morocco,7,6,1,140,595
0fe3477a-d289-4f19-9606-74ae2eda9f79,jacqueline76,46,Female,Sao Tome and Principe,25,25,0,1000,525
af0e2508-4c3e-4af7-8326-9ce2c0414130,gjones,56,Other,Cote d'Ivoire,70,27,43,1120,5390
525e276c-8d52-4d92-92a9-a8afc8becd78,bcurry,21,Other,Cyprus,14,8,6,392,994
3fa77763-409d-411f-8cc8-13f42da1cbf5,linomar,36,Other,Cayman Islands,47,42,5,705,3431
d92ef2ac-99f1-4e84-910d-6045ba45c987,foxbrittney,34,Other,Liechtenstein,38,8,30,1330,2508
3b4c14ea-8991-4437-a53b-cb0d4da46e77,ericking,64,Other,Maldives,34,6,28,918,1938
4f15da16-2685-4271-8d2e-3bcb06c5dd20,rwilliams,35,Male,Bahrain,49,24,25,1519,2548
a96fa709-b138-482e-9c2f-62aed5618866,sdixon,33,Male,France,50,12,38,900,2600
a20d414e-d362-42a6-ba45-0b52e10b43a7,becksamantha,60,Male,Bahamas,34,18,16,510,1190
feb79def-de99-4366-94f3-5023cf4c357e,karen33,31,Male,Uruguay,35,25,10,1085,3290
3036e89f-74ac-4c2d-9050-39fe3fe99e0a,gentryjean,57,Other,Poland,49,47,2,1666,1862
bd210549-f65a-4aee-94a7-4b5122a546f1,jennyrivera,34,Male,Pitcairn Islands,91,0,91,3458,5005
18602a5f-19c9-4388-8aa9-14dc8162818c,cassandrasantiago,23,Male,Mozambique,94,79,15,2914,3384
ef38bab8-337a-430e-80e8-733b74170d39,sullivanmichelle,49,Male,Equatorial Guinea,12,9,3,252,948
0dfecd8f-7dbe-4680-a8d6-641dbe9894d9,veronica55,60,Other,Andorra,96,30,66,3936,6144
150be887-f65f-43f7-9a7f-718b923cfa20,cooleydeborah,52,Male,Japan,64,17,47,2112,3072
128d2a2e-cb1f-4a2e-b027-3012e92fd73d,kyle45,38,Other,Moldova,37,15,22,629,3515
f1da23eb-c460-4fa3-b88d-5936b1ce5230,belldouglas,41,Male,Tunisia,76,19,57,2204,1672
3ae8814a-1e16-4dbc-8ea4-5b922e356022,mrivera,20,Female,Netherlands Antilles,73,69,4,1971,1971
d3215115-6c74-48db-8c10-c7fbc517e53b,martinezdanielle,34,Male,Barbados,91,32,59,2821,4004
147fb212-be11-40d8-83ff-dcdb5cd07bb5,denisegillespie,24,Other,Somalia,16,14,2,464,1424
09b666fd-c395-4d74-9435-231c316260a2,greendennis,59,Female,Iran,23,4,19,805,1679
c3add4d1-494e-49ee-94ba-3210d8dd3b6b,medinahunter,34,Male,Palau,90,23,67,3240,7200
4300bf6d-e247-4375-b96f-66599f419503,matthewgeorge,49,Male,Aruba,37,19,18,1480,2701
995442e4-45f6-4855-83ce-dd58bc5f13ed,matthew82,58,Other,Algeria,62,6,56,1488,5828
430bf75e-8cba-4c5f-b6e1-47311bb19a86,melissabowen,42,Female,Sri Lanka,31,22,9,1147,1488
e0ada8d5-6088-4f1a-9d97-2cd28445754d,cheyenne70,58,Male,El Salvador,64,16,48,1280,5248
b4b5101e-485b-4889-80d6-f0e0bd0cad65,cgarrett,29,Male,Romania,84,39,45,2772,7728
a8ed3cd2-d546-4401-8ef9-1a3facee5eef,stevenswendy,36,Female,Australia,55,0,55,2035,5500
11adeb5f-8d44-4315-a4b4-8cc516f07fdc,ryanmitchell,22,Female,French Polynesia,20,19,1,600,1940
eb8efaf6-1142-4887-b747-1899fc25573b,brandon53,22,Male,Cambodia,14,4,10,518,1358
a699ae0c-675a-40ae-aba1-6d12ede690bc,valeriejenkins,28,Other,Mauritania,4,4,0,76,208
14b2b7a6-1a3e-4cd9-b5e9-51c5b1d4a860,matthew53,21,Male,Ghana,96,75,21,2400,5184
55302d72-1c6d-4e79-b85f-4bd93dac4504,kbowman,46,Female,Switzerland,38,11,27,874,1862
85af79f5-c52c-4e70-a267-52e9144890ec,william65,49,Other,Singapore,33,2,31,627,2904
c6630003-01f1-40f0-9bae-2c4dd1e5805f,joshua39,51,Female,Vanuatu,47,30,17,1034,4324
0400ab82-f448-4d12-913c-b51c5085abb7,hbrown,27,Other,Philippines,24,5,19,648,960
09f0c379-8ca0-4a80-bdb7-35df611a7bbf,fmiller,38,Other,Sri Lanka,23,12,11,552,1794
f32fedbb-5007-4c11-9340-d6396770dbc5,monique02,31,Male,Bhutan,26,2,24,416,1326
e49b6f61-87a6-4d42-b323-797d5c1559ac,suzannebuckley,33,Male,Honduras,15,11,4,345,390
3af4de55-4b32-423a-a0fb-4ed3d7255003,peckscott,33,Female,Pakistan,28,25,3,672,1680
89257e94-a894-4074-932b-8f15d4b9c0dd,xsanders,39,Male,Hong Kong,4,1,3,164,196
98142a9b-979d-4b8b-877c-50c8848e707c,ythomas,23,Other,Philippines,20,12,8,700,1580
5304b9ba-12ff-4d1f-986c-0b241d745dc9,polsen,45,Female,Somalia,97,64,33,3007,7275
aebc5f2d-f8d5-4022-988e-0aee092cd223,kedwards,51,Female,Fiji,86,77,9,2924,2408
f7a038d9-9dee-4f4d-a6c9-920034992e33,hutchinsonchristine,48,Male,Saint Kitts and Nevis,44,6,38,1188,4092
c7586cbd-e3c5-4988-9adf-e5420edb0ffb,rachelcervantes,43,Other,Niue,4,0,4,124,152
a317b0e1-4d53-4053-8b22-c60cacb11011,mmills,61,Female,Guinea,53,17,36,2385,1696
8ef7870a-45c1-42a5-8554-2e4cf21efb96,kdaniels,50,Male,Guatemala,91,44,47,1365,6097
54e30239-19f7-4fe9-a7b8-37fb9bdac90f,qhowe,58,Male,Holy See (Vatican City State),32,24,8,800,1760
b4535ca2-7807-4136-93c7-65c7e6508574,yjones,18,Female,Martinique,57,14,43,2109,2508
dc4d80af-30b3-4fa5-9754-b5f106a59bcb,danielsmith,37,Female,Gibraltar,64,13,51,1216,4736
bebbdd16-a5ca-4b9e-be61-c50c0fac73d8,sanchezpamela,58,Female,Faroe Islands,38,3,35,722,3154
d03d2cd6-444c-424f-9a69-bf9ded26059a,uhancock,51,Other,Bermuda,57,12,45,1596,4161
16517708-82e2-4e5a-9090-b280d4fed414,pageashley,25,Other,Rwanda,3,0,3,78,204
515f8448-baf0-4a9b-9226-48695b604d8e,bradyrobert,37,Female,Congo,44,25,19,1936,1672
35dacfd4-5172-4706-b45c-81cf52f3ba04,anthony41,65,Female,Timor-Leste,60,30,30,2520,3840
e323b83c-6c00-4081-9053-3612c2b27240,ginayoung,34,Male,Gambia,3,3,0,132,87
b192dfdc-650f-4767-a6e6-2ef3a2a6772c,joshuasteele,38,Female,Rwanda,6,1,5,228,162
e2372193-31ba-44d6-af48-98412285ff10,ingramrenee,20,Other,Albania,90,85,5,1440,6840
dcb61bc5-248b-4ce2-8820-8e74168019c8,frederick73,29,Male,Gibraltar,19,1,18,342,1482
79c51a6a-5236-4770-89b9-acac6c835c0d,christinecollins,36,Other,Bosnia and Herzegovina,49,1,48,1372,3920
c57d7367-b245-4cd1-aa47-93a9eb2dd9f5,jennifer49,35,Other,Malawi,69,4,65,2070,6003
571d2800-84be-4480-ba66-7740de558eda,olsonmichelle,62,Male,Lao People's Democratic Republic,1,1,0,21,85
b4a9b79e-78a0-47d8-9105-cd935ba1861a,martinsherri,30,Female,Haiti,2,2,0,32,92
72872893-ed2b-4840-9529-1a00b5a4216d,patricia62,46,Female,Western Sahara,13,6,7,481,299
d2d7d373-a1da-4dde-89ed-c357378336ee,ysmith,34,Female,French Southern Territories,53,4,49,1166,1060
620e061c-2b77-4c30-bab9-7007a108f3f0,iallen,27,Male,Tuvalu,71,67,4,2982,2130
ea8bd7d5-3d47-499a-8a8a-5024c7a262f0,madisonochoa,46,Female,United States Minor Outlying Islands,24,2,22,720,1200
d48e16fa-6bd8-4d88-ac6b-4e1f1645a3d5,benjamin04,35,Male,Central African Republic,50,7,43,1350,1200
bef34244-c081-4248-850c-c52beca97bd3,jacobsparks,46,Male,Montenegro,50,31,19,1900,4000
c9ca143c-07e1-4cef-a0b2-e1e272e2adb1,pittssteven,37,Other,Thailand,7,0,7,224,518
45b0a502-3493-451d-9774-55368ced0324,hcallahan,60,Female,China,20,14,6,500,900
619f4696-3894-42af-8dda-d7239f45764b,natashabruce,57,Other,Cook Islands,15,4,11,630,1440
e4eee286-ed03-443a-b6c4-cb26d09bf21a,ksmith,38,Other,Northern Mariana Islands,17,0,17,748,731
4f85b39d-6ebc-4c02-b8fa-2b4c466eeca1,stephenwilliams,62,Male,Serbia,15,3,12,450,1305
014090e5-faf8-4732-93a1-ff775872fef6,gbenitez,37,Other,Cocos (Keeling) Islands,74,28,46,2220,7104
6f6d3975-179f-4365-8a4e-2e65bb276af5,jeffreyleon,46,Other,Guinea,76,5,71,3268,2052
405e6756-1f6a-465c-84e5-d39d2ee28bad,mprice,31,Male,Madagascar,30,26,4,660,1200
9071f22f-8d25-4301-98e0-855e089832df,jmcguire,61,Other,Congo,69,4,65,2346,2829
34c9c511-b19b-4639-a154-191c282a65ad,ywarren,22,Female,Monaco,9,9,0,405,801
1b7bf657-487a-4cc3-939a-0b8c27963dce,joel90,28,Other,Liberia,21,18,3,735,1701
18d2542d-ac92-4c8b-a220-ccee7ad140c1,michaelkoch,50,Male,Djibouti,100,99,1,2500,8000
332c0a8e-234a-4629-86cb-7713fd51afa3,haynescassie,37,Male,Slovenia,13,0,13,468,1209
db022f80-3475-492a-83c7-07932aaeeec0,vwells,57,Other,Montserrat,76,21,55,2204,5396
0f364230-a902-4c58-acca-a1c1f9ba2dfa,mary82,64,Female,United Arab Emirates,100,30,70,3200,4900
5af62f88-a86f-4a65-b7f9-478d3bb6d464,davidallen,33,Female,Egypt,87,49,38,1653,2001
6ef975f1-9259-457a-ac04-c13df2bf9b34,davidcaldwell,44,Other,South Georgia and the South Sandwich Islands,26,10,16,1092,858
d1c37077-6197-41c3-95a9-435e3b0f098b,reidchad,47,Female,Antigua and Barbuda,85,45,40,2465,4590
1c61dc1e-0484-4044-a43e-247de18dacbb,browndaniel,34,Female,Lithuania,79,74,5,2133,4345
b5b1dcdf-d614-4238-902c-3e3a1415328b,gregory40,39,Other,Namibia,58,48,10,2146,2088
7d6b4e6a-f9de-4e31-a94f-d2292b85de4c,benjaminschneider,65,Other,Angola,2,0,2,80,194
7a0d8d44-f1b5-4c4d-a831-2fbc7ea3be29,zacharybuckley,35,Female,Burkina Faso,48,10,38,1728,1296
fe7d1f95-d7b7-4033-8f00-3424cd1452d0,allison56,22,Male,Korea,67,63,4,2747,5226
a2869513-2f5d-45fe-a47f-68aa6103e7b3,msnyder,53,Female,Bosnia and Herzegovina,45,11,34,1710,1980
e9e666a2-bff9-4b26-be74-fdac52edabaf,frasmussen,28,Male,Luxembourg,5,5,0,210,410
269a1814-c9b4-4e60-85d6-c2274da7713b,joneswarren,34,Male,Bolivia,14,11,3,462,1386
7c1d5cee-15b5-4865-8cd4-f505dc01b0ba,michealford,65,Female,Nicaragua,96,93,3,2016,8256
6d7da749-77dd-4e07-88c2-26d99d21cb5b,nathan72,27,Female,Kuwait,45,26,19,1215,4320
419254a5-20ef-43a5-b8fa-6eff5d5de415,mark50,43,Other,Bouvet Island (Bouvetoya),74,38,36,2442,7400
86420222-41e2-4bbe-94d4-a5a4d1b61f0f,adeleon,20,Female,Angola,57,35,22,2451,1596
bd245d3c-dd7a-4764-9532-809b39f658b6,cherylguerrero,47,Male,Nigeria,94,56,38,3008,2726
1408402d-a3e4-4e0f-9773-8cce2ad7a878,shermanjennifer,65,Male,Netherlands Antilles,77,58,19,1771,3080
bdb9af8c-afa3-4acd-a344-ab82ae4db606,eshepard,56,Male,Tanzania,17,13,4,714,799
751653ec-78b9-4739-b6ab-79107964885f,william34,27,Male,Norfolk Island,95,2,93,3610,7790
8683bed5-73dc-4343-be2c-09302f571633,shannonwalsh,37,Female,Kenya,81,5,76,2268,4536
6d58605e-4dd0-42ec-8791-4d2a8462752f,ralphlloyd,34,Other,Macao,60,33,27,1380,4980
506db8aa-a983-4b16-b9f1-e41e5ba6ffba,abyrd,21,Other,Niger,34,12,22,1394,2176
418e38d8-70f3-460c-adb8-f38372d2053f,kingjessica,35,Other,Mali,36,30,6,972,2664
463a5c35-4046-4970-af80-831a2d30b1b3,michael81,45,Female,Saint Vincent and the Grenadines,5,2,3,100,315
e5ec04e7-defe-44ec-a999-a816cf931c93,kramirez,42,Other,Kyrgyz Republic,63,58,5,2646,3591
221534be-0dea-42f7-abd5-bd226e80e23d,floydjohn,42,Other,Kuwait,59,59,0,2360,4130
19f20b33-75c9-4402-9865-202aabe6defb,jennifer21,32,Male,United Arab Emirates,92,78,14,2116,4692
6bf31c72-5b6a-457c-96b9-30241a43eb6b,zpittman,36,Female,Guinea-Bissau,36,25,11,576,1944
3b69336d-ca31-49b3-8dc0-bbb355c01564,simonkayla,35,Other,Angola,75,69,6,2550,3075
75feb00d-5753-4a0d-ac74-6f25ffeb665c,nicole17,38,Male,Ecuador,47,40,7,752,3149
568eea0c-29ad-46ec-b88e-b2bb042244a1,howardtiffany,26,Other,Netherlands Antilles,36,28,8,1152,2268
9137c260-9d9b-49c4-8511-2d54ba7e07d0,ochapman,48,Male,France,64,24,40,960,6144
9164f5ef-81c0-45c1-99da-79eb872e49e5,fperry,26,Female,Djibouti,33,22,11,1353,1452
04e313ce-0256-4738-a992-5e0ce5a895a3,lstewart,42,Male,France,61,43,18,1891,3050
49156615-8195-47e4-9e80-015bc760bacf,dcruz,56,Female,Wallis and Futuna,8,8,0,336,768
14edc911-b4c4-4c39-a6a0-5d0e42e17a90,lwalker,44,Female,French Southern Territories,41,8,33,902,1476
47b0eee6-1239-44ee-9e7c-a2b05b32d06e,eric33,55,Other,Kyrgyz Republic,97,4,93,4268,8148
be3e1574-0e0b-4334-9163-4437d83e5618,jevans,25,Female,Canada,86,28,58,2494,3182
d20b0c1e-a7f6-4be4-81e9-c447e03ee064,pamela69,49,Female,Bahamas,41,11,30,615,3526
6ef1f3df-eadc-41cb-88d1-8b4d133c1642,whiteheadadam,41,Other,Saint Vincent and the Grenadines,60,29,31,2340,4200
b74d5f05-96cf-4bec-9868-2453a317307a,hurstthomas,30,Other,Lesotho,20,2,18,500,1380
5e1e6a74-d726-45f4-ac56-56ae786614f8,urodriguez,21,Other,Bahamas,66,29,37,1716,6402
aeeb166d-42ad-4d14-b98d-92070b2592be,emorris,44,Male,Tanzania,40,11,29,1240,3480
34548557-faca-433e-91bc-8e347b69d0bf,elizabethbennett,24,Other,Austria,50,24,26,850,2000
4fd6fe35-0f1b-4f61-8072-137c0a81fbe8,smiller,41,Other,Tanzania,29,22,7,1189,1334
9c32b20e-548e-497e-bb90-59617988d8d8,wayneweaver,49,Other,Venezuela,54,47,7,1674,2754
35ec2bce-7773-48f8-8162-ba176d6018f4,alexandrajones,61,Female,Moldova,17,1,16,680,544
93a1ad26-2f08-4933-94be-5eca17f42e15,connie99,29,Other,Micronesia,42,31,11,1176,3444
9a3616d2-f795-4b45-9753-355363a7519a,katherine28,48,Other,Sweden,83,79,4,1743,1743
3edc7d16-3b1f-4347-b455-f3753f9ba400,taylorkaren,61,Female,Israel,73,2,71,2117,2336
15e74ea4-f6bf-421b-b027-4190c1426246,rrodriguez,56,Male,Paraguay,79,65,14,3160,3160
d722d290-8257-4e1b-9576-8c86f5f950ba,debra51,61,Female,Gibraltar,20,4,16,580,960
253965c2-f481-434c-9ff2-e92fe5969dce,egriffin,33,Female,Hungary,90,15,75,3420,6930
60a19e2a-512a-4ce4-8e94-4a96c9030f4b,lukereynolds,38,Female,Ukraine,93,35,58,3348,2511
b6bc0b8e-2aad-4655-a0f0-c2e484d515a5,hamiltonmatthew,19,Female,Ukraine,6,6,0,132,390
a43c0849-38ba-4408-83f3-c0b4af573ab6,johnsonamanda,38,Female,Bhutan,59,29,30,1888,2950
3ed8f779-6044-42bc-846a-63fb0244fe6b,kevin27,59,Male,Tuvalu,65,58,7,975,1625
25cc18d1-9854-4dfe-9845-133771e9000b,yrush,31,Male,Spain,74,28,46,1628,1554
e4218900-3ee2-491f-9bb1-93654a6753e8,roger15,58,Male,Paraguay,34,2,32,680,3162
b2ba9719-7049-431d-b793-d1749dcefbc7,zholloway,55,Female,Tuvalu,15,9,6,240,1440
af1167d5-6768-42fc-86c8-12221f4bcc9d,matthewcain,18,Male,Hong Kong,22,5,17,352,1078
859686ab-2c5f-446f-acef-99772fb9a86d,diane13,35,Female,Ethiopia,57,48,9,1140,3648
4708a554-b869-4eb3-ba91-78f832cac6f9,gallaghersuzanne,41,Female,Palau,1,0,1,21,62
8ebdf17b-f4da-4637-9365-59196a222c7e,daledavis,40,Female,El Salvador,48,22,26,1344,4320
b7a8bad3-c3a1-4b95-bcd7-ab28a53c0f10,catherinetaylor,52,Other,Nicaragua,7,1,6,308,420
96f7833d-2d7d-4e23-b483-f735e667440a,leewells,40,Male,Tunisia,45,26,19,990,2250
2e37c784-bf83-415e-921d-d0642666807f,craig68,27,Female,Saudi Arabia,97,23,74,3395,4850
d1ba9d8d-5971-47c3-abf7-1a0c7a654823,vwilliams,65,Male,New Caledonia,78,8,70,1872,3276
637c9b0d-bc76-4887-84a1-7a6b25c41e46,mcdanieljeremy,33,Female,Heard Island and McDonald Islands,69,1,68,2415,1380
10123057-30a3-45c3-a588-c02ce33d5bf9,terry29,58,Male,Heard Island and McDonald Islands,83,61,22,2905,3071
df4d0148-11cb-4797-89d9-f4e5a30b4163,dana95,49,Female,Poland,90,23,67,3060,8280
c24ef41a-7ce0-4689-ab75-a80bfc5b3abd,kimberly78,18,Male,Lithuania,62,6,56,1488,4650
7fdb808a-953a-4165-82af-8081057ef92c,dylan77,59,Male,Venezuela,61,60,1,2684,5917
6527ee03-061c-468d-9452-f19892c31ead,autumn95,56,Female,Uzbekistan,84,12,72,2436,3444
838f2df8-50c9-4496-af75-de50d5d5267c,robertgriffin,59,Male,France,4,2,2,180,116
f1ff7a07-ee72-4100-ae8b-b4d0b8684749,gallagherjonathan,32,Other,Nauru,74,9,65,1110,4736
8c2a25cd-3d5c-4381-b856-3661d8aba9c4,mcconnelljohn,39,Other,Malaysia,96,51,45,3744,7680
54210d05-c5b6-47dd-80b5-bfecd347bde3,elizabethsimmons,51,Male,Bangladesh,42,34,8,1386,2898
ca230139-6743-4cab-837f-e650a0c27bfe,christianerin,30,Male,French Guiana,96,10,86,1536,4512
5cb4ef39-c2c7-454a-b91f-a3f8739c9373,iwatts,21,Female,Faroe Islands,82,76,6,3034,1722
3954aaae-5091-4e6a-ad7b-3b474f7f456f,veronica58,26,Male,North Macedonia,77,48,29,3157,2079
3a9ae0e1-c6a2-4add-88e8-fc90dbe924ab,klinejared,35,Male,Malta,3,1,2,87,93
7005f82f-fe4e-45d3-a3a0-72742c9ad4ee,chavezdennis,19,Other,Bouvet Island (Bouvetoya),61,12,49,1891,3965
934a9001-eb16-4889-8a9d-281bf854126e,collinmiller,28,Male,Paraguay,58,8,50,2320,4002
40423dc3-3875-41d7-baed-8ec93d88ffe8,melissachapman,60,Female,Saint Lucia,40,2,38,1320,1560
9ef16bd1-0fb7-4725-ae19-01250f1ede74,gabriel49,22,Female,Greenland,33,18,15,1155,2508
c06e85ff-755c-4952-af89-a88ad5fe2945,larry88,52,Male,Mongolia,97,86,11,2425,6790
6abe0f07-7a43-4a93-836f-c00090dadf5b,danielle02,34,Male,Madagascar,18,2,16,648,432
8a472300-6938-4968-9279-cb1ca4f12259,melissavazquez,50,Female,Zimbabwe,96,37,59,1728,8064
4e4f9cf8-ab87-47bb-8d2f-8272b682ccf7,luis00,38,Other,Belarus,68,24,44,2788,5372
ac7aed77-ddb0-4c54-8ee3-f2cb6215d765,russell11,44,Male,Saudi Arabia,15,2,13,285,660
283b0b39-3748-4fc5-844c-1cda069668a0,acortez,18,Male,Switzerland,12,3,9,444,1152
afd832ea-a69e-45f8-b607-e3e6c5b33176,castillojennifer,23,Other,Myanmar,89,24,65,2670,5162
c8b758c4-42af-4072-bbe9-bf92ae97a84e,hinesedward,40,Female,Bouvet Island (Bouvetoya),3,3,0,66,243
544cffe6-fed1-4915-a7e1-41d58552d8d8,patriciacisneros,60,Male,Norfolk Island,13,1,12,390,1274
6b46627f-4d7e-4bfd-afa0-393f44c05c23,cbird,61,Other,Cocos (Keeling) Islands,6,3,3,240,396
e3ff6c84-5922-43ef-8644-153542c85b24,tara12,18,Female,French Southern Territories,10,4,6,250,640
7e97a349-689e-4229-95e8-bc876f3239db,mcdonaldkristen,46,Other,Cuba,20,20,0,660,1580
b4f4986f-0b5a-466e-84fa-1b8750dd533b,qburgess,41,Female,Afghanistan,55,52,3,2035,3630
4ab82d54-f9be-4a0e-8d79-975240b9bc86,ipugh,31,Male,Oman,33,13,20,1089,3201
06bf7436-b1e4-4461-96c7-a534665e2718,greenhannah,64,Male,Gabon,88,40,48,1848,8624
82dfb0c6-7ba8-4250-9426-cb0346c2b356,austinwright,40,Male,Lithuania,72,23,49,2160,3600
314c8004-34d0-4c4c-9fb4-3951596968ca,jenkinstammy,28,Female,Niue,62,55,7,2046,1984
6da36d7d-65af-4f98-a44d-c85217cdfbff,janeduncan,48,Male,Bermuda,96,56,40,1728,6816
19c0c527-30d9-433c-9608-c0714af35906,kellyleach,62,Male,Gambia,69,62,7,2898,4830
4fb662ba-83ea-4ec3-8632-3e3c8437b6fb,barrettkevin,60,Female,Somalia,37,9,28,703,2442
c94d8e49-98f9-409e-81de-6db0e25faae0,ileon,49,Other,Gambia,55,46,9,825,2200
772eba84-8d9e-4386-8adf-f5b742f7c621,barrettalyssa,35,Female,El Salvador,76,52,24,1976,7448
dd7c36b6-17d9-48a7-a6fc-bafa4b9be142,lhamilton,52,Female,United Arab Emirates,96,4,92,1920,5280
42269fff-0835-4c12-9fe3-6fc12dc1bc8f,smitheddie,57,Female,Korea,37,2,35,1073,777
bb22a7d1-95f6-4512-8cb2-dbaba8c5214a,carlagarza,60,Male,Mauritius,98,13,85,1666,7252
741d64cc-ad27-4ba9-9639-2b8a8e58806a,jameshall,40,Female,Mauritius,12,3,9,396,336
3470e4d7-b12f-4562-afcb-1bc1d700b492,wbowen,65,Male,Albania,85,66,19,3145,3995
64f5024c-6064-40e3-a8be-7443d12cca9e,alison70,29,Female,Solomon Islands,18,13,5,702,1620
0aae2448-58c8-4ef7-97c9-fdf2c0fd48df,heather89,61,Other,Honduras,32,20,12,512,1440
ad36d364-76fe-47f5-91d7-e78d2dc50263,amorris,28,Other,Greenland,39,28,11,1599,3666
0338a22c-6462-4f1f-9128-7872a6cb1258,stephanie73,43,Other,Bhutan,23,15,8,460,2254
82228233-9dab-4428-add7-feabbe407dc8,michelle05,43,Female,Reunion,82,33,49,3608,5330
eeb132a0-4302-4e1f-afc0-f3800f205918,sonya42,28,Female,Argentina,35,19,16,770,3255
cd0e45da-4d7e-4709-a265-3ab04791cdde,ibrown,38,Other,Tanzania,99,28,71,1683,9207
8e71ea4b-5612-4399-bc1f-eb62235a4116,natalieflores,26,Other,Netherlands Antilles,63,32,31,2835,3024
5c23e613-7efe-4780-9dcb-389af25988e6,johnsonmichael,34,Female,Isle of Man,100,33,67,3900,4700
d39cfecd-aa32-4359-8b76-5e20d1b02c6c,michele18,23,Female,Bermuda,61,41,20,1647,4941
c35c58b5-8fa9-40aa-886a-916d31d88198,tdennis,57,Female,Marshall Islands,92,92,0,3128,7084
1f1d1f9d-27f9-4504-81a7-70bf9540483b,louisgross,48,Female,Malawi,94,12,82,3854,2162
8400bf8e-741f-4a3a-8757-1c9970a64064,kathryn44,27,Female,Antarctica (the territory South of 60 deg S),41,14,27,738,2296
d470534b-f1e0-434a-8720-63da90e31fab,woodanthony,58,Female,Myanmar,12,1,11,504,612
b7d20f3b-ca73-4979-8c4a-0b1039f5cd02,gabriel79,28,Other,Zimbabwe,91,37,54,1365,6188
8e15f5e3-e82d-46a6-b6b9-54bbf7774cba,daniel99,53,Female,North Macedonia,37,14,23,1184,1554
17b5af64-adc4-4e5e-aeb8-0f0bb7a4fa9d,andrewbaldwin,60,Female,Mongolia,89,34,55,3026,1780
3adc0d97-2edb-41e3-accb-32e05cb76dea,fuentesalexis,28,Other,Gambia,70,57,13,1330,3080
b87acf67-2dfa-477a-aca3-01e208b0f005,theresa80,64,Other,Uzbekistan,76,61,15,1596,3800
1bfe7100-8a76-47c6-a1d3-32e10538fa4d,rose02,23,Other,Northern Mariana Islands,27,13,14,648,2160
40bde305-10dc-40f3-8d71-3944437fd04b,mtodd,57,Male,Dominican Republic,98,46,52,4116,2646
df489aaa-19e9-4fb0-a909-c3de53fc25e2,christopher14,58,Male,Guam,15,9,6,405,870
554662cc-81cb-4979-9af2-bfbc99b4831c,taramitchell,24,Other,Belarus,22,2,20,924,1452
80ba8030-5e7b-42fb-8d45-cfbf4dd840c7,mmeyer,20,Male,Ecuador,30,29,1,1050,2250
48bfcfdb-a88a-4f3c-9b8b-8c89f1b14faa,bmatthews,40,Other,Israel,86,43,43,3612,3096
a97772f1-22a4-412c-a050-088eb3850818,lorettaduncan,63,Other,Aruba,90,53,37,1800,4410
1be16e36-3de6-40e2-8922-45e391d5f7e2,schwartzjamie,43,Male,Barbados,26,18,8,1040,2392
b65fbdd6-7a67-4178-9616-070ef530c4fe,wpitts,19,Female,Azerbaijan,20,1,19,560,980
46bcf5f0-b25b-4384-bed7-d894224835a9,wesleymoss,23,Male,Latvia,74,60,14,1924,2738
edab71af-3b5d-450d-87fa-3c74a3eb0aaa,nicolebennett,33,Male,Cuba,77,50,27,2310,6699
8d0b4dd0-6a19-4176-b265-058f6928894d,brentfitzpatrick,35,Male,Croatia,1,0,1,36,31
b0a0010a-8dac-495c-9d62-9bb03c9450f8,brendagreen,59,Male,Cuba,24,4,20,576,504
5b951db7-a827-4555-94c3-bd3e709aa5ab,rodney29,36,Female,Bouvet Island (Bouvetoya),54,25,29,2268,3132
01baf164-7acf-4500-a2ca-1f1dd301bd44,stewarttroy,63,Other,Montenegro,12,7,5,444,528
78d75aeb-2391-4e79-aa35-74353dab5663,kenneth86,22,Other,Niue,24,11,13,792,1944
473c499c-bfb1-499d-b13f-8ae8b7b647dc,gibbsjenna,35,Male,Bulgaria,77,74,3,3157,5082
294a95d9-19d9-451e-aba3-5f01c29f673b,ginathomas,35,Other,Vietnam,18,0,18,288,990
73af042b-18b1-4c7d-a2df-458a25d30eed,fward,45,Male,Jordan,83,7,76,3154,3735
938d9158-6c8e-4ae4-b5c4-85eb19af9f41,vpayne,22,Male,Burundi,8,4,4,240,760
4d267f71-723e-4800-b329-3abe6f37dfe4,whitesarah,57,Male,Jamaica,54,11,43,1836,5130
640ce062-fd14-4dea-aeb0-5c8eda8f61e8,ahorne,53,Male,Wallis and Futuna,99,28,71,2079,2574
def0a739-bd82-4987-8fc5-87d9833c240b,robertbell,26,Female,Ukraine,100,18,82,3700,9000
3fbd4170-4321-42b5-87de-b7ebdf92d67c,pmartinez,44,Female,Bangladesh,48,32,16,1632,2016
5ddd3706-352a-408e-a969-2e2ca6163fcb,smithvictor,61,Male,Finland,68,60,8,1360,5168
bddfd8e2-7d35-4d27-b272-c2d1a6a9684c,sara51,28,Male,Congo,6,3,3,234,276
b68078d7-4f4d-4a89-88a5-eac0878a4194,ddillon,35,Male,Cameroon,69,10,59,2829,6624
d0b4096b-a9d2-45c1-aa34-760efeb8d020,tmartin,36,Male,Mauritania,71,61,10,2343,5112
1a38e328-ee15-4151-b1cd-a0a89bc6f241,yshaffer,53,Male,United States of America,12,6,6,228,924
c6e23afb-3d5a-4f25-b26e-cf7372b92ee5,charles04,24,Male,Egypt,54,36,18,1242,2052
1c23ffd5-be0b-47b1-9d06-3a6210ed9805,edward82,48,Other,Iraq,46,43,3,1196,2208
fde4e8e6-45a9-469e-9d0e-89f4718885c7,tracy47,56,Male,Tunisia,4,3,1,152,128
aeadeb91-c09d-4207-a0d3-f3297b1970cd,elizabeth88,43,Male,Botswana,3,2,1,117,78
3606b41c-1205-452b-b6c7-538a8ca21a9f,linrebecca,45,Other,Nigeria,90,49,41,1710,2250
ecd00256-85e5-4356-a736-8559c059915d,greenenicholas,45,Male,Guinea,99,97,2,4059,4455
859d5031-bd85-4a81-a0d2-d421f375546e,susanmoore,51,Female,Netherlands,73,45,28,2920,4453
9322c3f8-3ad6-44fc-a60a-7f6a2f2b0147,erinbrown,56,Other,Turkmenistan,41,12,29,1107,1763
911ab617-5ba5-4c52-8d99-3f533adb06ca,garynelson,23,Other,Mayotte,12,12,0,384,1152
c6d6fe18-8273-4da8-add3-fb9039e7d521,anthony34,26,Other,Comoros,42,16,26,966,3738
79659921-209b-46b4-becc-9715958f9385,april94,32,Male,France,13,6,7,208,286
b14dce7a-9c80-447f-88b4-01f72dad3919,stacy04,37,Other,Norway,23,21,2,368,575
c6a1b035-5179-40d0-830d-ba69a5d3f807,joseph49,19,Other,Estonia,55,22,33,1705,2695
8bd4a1aa-9682-4c39-9c88-f538c04b5577,dsnyder,39,Other,Burundi,26,9,17,442,650
5ae36cb6-0aff-44a7-a957-3c962d36d2b9,christopher16,27,Female,Aruba,71,56,15,3124,1917
07262109-cbcc-4d88-9042-336f0538a53c,stevenlee,47,Male,Mauritius,88,53,35,2376,6512
bf53ad60-cf01-4b58-9929-109ba2e4e9b5,joshuawilliams,43,Male,Serbia,89,77,12,1691,3827
d7234258-be3d-4b1d-a272-815e8a3c93ec,ymurphy,54,Male,Saint Martin,68,24,44,2108,6528
66205903-db0e-4ef7-8d08-2a6957db7026,jason19,45,Female,Cayman Islands,61,10,51,2501,5368
94e14f4f-b3ee-48bf-a937-ffde6db43832,mollyhernandez,19,Other,Congo,89,58,31,3026,2047
14b07116-2c84-4ff6-b9f5-689967a06f61,rodriguezsteve,25,Other,Isle of Man,12,1,11,480,948
aa61a5b7-8a9c-4436-9d6e-41566c66ced9,ryan87,61,Female,Tunisia,64,33,31,2240,1344
260010bd-c2ea-40cd-b636-acfa2ba6cae6,brian91,40,Other,Nicaragua,55,36,19,2145,4070
7f1a5df6-a8a1-46f3-9767-abc1890793fa,crystalmcfarland,38,Female,Korea,74,34,40,2220,4440
d8afb643-0f2f-4d82-b3fc-63b06125177a,adamrussell,62,Other,Dominican Republic,4,0,4,128,140
843f2be9-07ae-4190-9d0e-698a00bfb84d,julia63,64,Female,Kuwait,66,28,38,2376,2706
9238972c-75b4-4627-999e-f413f1a01d2d,gshort,18,Other,Haiti,7,3,4,294,637
25fc0bbd-d816-4af2-910a-31174c1d2f32,iholt,52,Female,Madagascar,46,28,18,1288,2576
fe4319d3-9928-448e-83c6-4bf15acd186e,robin60,57,Other,Falkland Islands (Malvinas),28,11,17,1064,700
515690ea-e5e9-4cc9-93e0-8e374a65738d,daniel88,47,Other,Belize,12,1,11,504,768
365ffc83-4b98-424e-9c32-77a6290ab2be,timothygriffin,35,Other,Marshall Islands,37,17,20,1332,2960
58a3d45e-7ca0-4deb-a0c8-f8093aaf3718,joymoore,39,Female,Micronesia,42,13,29,1260,3948
d89cdab7-c268-4599-b442-ece3544559fe,kimberly72,38,Male,Saint Lucia,20,12,8,300,1040
1d37424d-134f-4c7b-b42c-e01ab5948076,megantaylor,41,Male,British Virgin Islands,78,61,17,1326,3978
0c35cd1d-d225-47d2-98a0-1956f4db50aa,david97,45,Other,Algeria,23,8,15,828,2185
f35be70d-0010-4c84-95c1-c0b6465a253d,scottjohnston,29,Female,Montenegro,44,43,1,1188,1408
77d7a680-873b-421b-a4b0-5632937a2819,racheljohnson,43,Male,Tanzania,76,23,53,1292,3572
dc79bf5a-8df9-424c-895e-6af54c8d81ea,daviddavis,63,Other,Papua New Guinea,26,15,11,676,1820
8aa3f76a-46bf-4117-ae3d-5e768f0720b8,chernandez,24,Male,Cameroon,47,6,41,1739,3243
9c29c903-1480-4a2b-a9cc-4801a84f174e,james68,19,Other,Lao People's Democratic Republic,89,50,39,3382,7832
a23ffe7b-d47f-4b3e-8fba-cc2c2571adea,kelseymiller,20,Female,Seychelles,43,6,37,1591,4214
d24af09d-aca8-47fc-b32c-9e7fad34bd3a,schroederdouglas,43,Other,Solomon Islands,67,8,59,2613,3685
982c935f-ba4f-4a36-9ac2-5aa4a3fb2fd2,robingarcia,55,Other,Cape Verde,36,29,7,1152,1188
f7be453e-3d11-4f6f-819d-cd9d9df98ad3,gailfisher,24,Other,Cambodia,55,10,45,1705,2585
1a64b9ce-8757-40c2-99b3-f3a673ee086a,jennifer02,52,Other,Botswana,77,8,69,1617,1540
dacb51e5-41a5-45da-b468-aee6049fc9d4,alexandrakeith,31,Female,Congo,16,12,4,336,848
39fba0b0-33cd-4d94-b58c-18d6cf9f5d99,zanderson,59,Male,Dominica,62,15,47,930,1364
7457b688-06ec-48a5-9825-308fb66516c3,christinahutchinson,45,Male,Faroe Islands,39,39,0,780,3237
aa353f1e-b55d-4d9e-8eeb-018bde7d661a,gaymegan,28,Male,Antarctica (the territory South of 60 deg S),67,1,66,2412,1876
fff35cac-49c0-41c8-96f6-5df23c082dd8,christopher40,57,Female,Czech Republic,69,27,42,3036,6693
622cacbc-b7f0-4fb5-96b6-97b073894858,perezsophia,40,Other,Turkey,15,0,15,510,1380
b2cba3bc-e348-4f81-a1ec-21a482f2219a,amberward,24,Other,Saudi Arabia,44,10,34,1848,3080
67e22081-ce44-4c3b-b2b8-6f0e489dc03d,chapmanevan,21,Female,Lebanon,37,3,34,1147,2220
8529e897-ac44-463b-9197-9e5064d02049,joanne28,41,Female,Niue,75,34,41,2100,5625
5a47d3ef-c236-4a9a-b236-288c77e2a722,bortiz,19,Male,Serbia,78,39,39,3432,2808
69a09137-ebec-4f5b-8ecb-4536fd4d817f,nashsonia,26,Other,Algeria,86,78,8,2838,1978
2e20996d-fe1f-4eca-b020-bbcebdbfd91a,jennifer11,63,Female,Fiji,74,66,8,1480,5624
5f68459a-aebd-439f-80a9-4a4f49625c0a,lauragonzalez,62,Female,Brunei Darussalam,5,2,3,90,110
0243855f-c60b-40e8-a553-0bc58dd52c34,flee,55,Other,Switzerland,80,17,63,2480,4160
3f196d29-319b-4c7a-bcce-fbd75cece61d,coreyross,41,Male,Egypt,51,36,15,1275,2193
3494cb63-4c41-4747-8108-ce69f91f5298,christopher26,19,Other,Mongolia,14,5,9,630,742
69a80640-b057-4f5a-89d2-bd35693f6f32,qsilva,27,Male,Taiwan,93,83,10,1953,9300
ae4e76af-6767-424e-9ece-fb485d1e43ce,martinezkristen,55,Other,Papua New Guinea,100,31,69,2200,2400
1b0f2ad0-de2f-4e0b-939c-ab189d20f262,phartman,61,Female,Namibia,13,5,8,403,1209
e11e741c-02fb-41c3-b304-ed0360983bf2,quinnaustin,19,Male,Austria,52,1,51,1352,3848
a4de3f9a-395f-43ba-94c7-e58694a84291,davidmiller,44,Other,Oman,60,46,14,1500,4920
34bcce29-fc06-4143-a064-6df7a78fc973,jenkinsdavid,47,Other,Niger,65,7,58,2210,3640
ab6c4794-b505-4532-8fa1-599ca68dac49,crosbynancy,58,Other,Chad,85,15,70,2125,4675
ff6426f8-14dd-4a2f-b9ab-29f32bdbe251,johnsmith,22,Male,Saint Martin,57,23,34,2280,1254
ad0c4583-8c21-4521-bdb5-16e4c4b74479,gina55,23,Male,Gabon,40,37,3,920,3320
d34a50ed-4a08-4924-805a-a8bdab5e0d41,jonesmelissa,28,Female,Belarus,79,31,48,1501,5925
083e4360-53f9-4fc2-a4be-69cdf129fa3a,kevinwilson,54,Other,Angola,12,3,9,180,516
3008a965-d416-4180-a49b-e676abe05c26,farrellteresa,50,Female,Panama,57,4,53,2451,3135
c1b79f74-9b33-4782-9298-9848eb06e76c,dorothy61,64,Other,Vanuatu,69,46,23,2898,4209
84e0baad-54fd-44e8-ad99-ae3f4200faaa,mccoyrobert,58,Female,Bermuda,7,1,6,259,343
0970e707-a910-46c5-8eea-965950327c5d,ebrown,19,Male,Taiwan,79,44,35,1659,2607
05bd8585-4583-49b2-a2c8-6cd7598ab69d,longmelissa,23,Female,Nicaragua,82,64,18,2788,8036
3c37e7ce-8a1b-4915-be66-d00089fb5dc1,kbutler,56,Other,United Arab Emirates,60,52,8,2220,4200
3bc1797c-c268-48df-8078-09ceef1a0504,uharris,57,Female,Colombia,17,7,10,391,459
9acbeff4-a283-486b-9e42-33c36d6ee2ff,david34,40,Other,Tanzania,44,34,10,1848,4224
8036cd1e-e3e6-4f60-b422-0d3310c952ad,athompson,58,Female,Uruguay,51,33,18,1734,4590
dbf65d59-72e7-4181-ae08-2f55c651f64f,gonzalezpeter,62,Other,Zimbabwe,46,21,25,1334,2530
042f0035-dec3-43a9-94cd-b5a231b21338,victoria79,45,Male,Jordan,97,58,39,3589,2910
7b217a0a-034c-4858-bf4b-69e8f72152c3,uhicks,53,Male,Mongolia,90,65,25,3330,6660
31c4f61a-753f-412d-a323-4f391ad2afd6,sdecker,35,Male,Afghanistan,69,48,21,3036,3036
69ce42f8-1fe9-497c-93c2-e1cd2f6ae9b7,stephenwilson,20,Other,Costa Rica,17,10,7,255,1122
8f43befe-f69c-4939-886e-44c8e939fc85,dayjason,32,Other,Tonga,62,11,51,1860,4278
58af75ec-349d-462a-a435-3052a62fc115,andreasmith,42,Other,Panama,59,30,29,1003,4543
6e895a5a-0d79-48c7-a4a4-d6389cafa194,sherrishepherd,42,Male,Micronesia,11,5,6,187,242
3a3517b7-1427-4dc9-adee-1c6e87e7464e,dawnwoods,58,Female,Niger,87,33,54,1914,8091
df500b2d-342e-456b-9a3d-5e8688e1dcc2,kpowell,58,Male,Honduras,77,57,20,2387,6622
15591f27-48be-4fdc-9ea3-de114b996dc5,jameslopez,61,Female,Saint Pierre and Miquelon,89,18,71,2848,5162
b853f2d8-5774-4666-8d2f-e445ec63d8ed,lucasaustin,42,Female,Saint Barthelemy,92,41,51,2024,2116
f7eb3f6c-f316-40a2-a18e-2e34d14a4160,lroman,32,Male,Vanuatu,34,10,24,1258,1224
9e3a99f7-18d3-4fe4-85c3-0635cabd4c18,karastewart,29,Other,Azerbaijan,99,15,84,1683,5742
685bb807-6fe8-44c2-94dd-b67afdd5339f,johnsonmatthew,31,Male,Oman,33,26,7,627,1485
7bd684db-b1e8-4188-abda-4d5056832aa4,gleonard,32,Female,Chad,72,45,27,3168,2376
2e4d4fe4-fb2c-4b1f-aa48-df87cf97c952,millermary,19,Male,Bhutan,48,44,4,1488,4416
058b0be4-7e7f-4f49-ac71-7be4ff8f9c2f,callahanjacob,37,Male,Turkey,81,49,32,2754,5832
dbc64ce5-f559-4be3-86fd-a289d3bc298c,robertsbrittany,61,Other,Guernsey,82,51,31,2952,3936
3db16967-1139-4e79-9fe9-9dcbd2334c52,adillon,61,Other,Comoros,25,20,5,450,1975
70c42e85-935a-4c17-b04c-01a4b994ea93,smiller,19,Other,Tunisia,31,1,30,558,1860
6ad37d51-c3f2-41f1-b812-f9adfff0843a,nsingleton,19,Other,Liberia,1,0,1,40,75
169f0ba1-f5be-431b-bb47-95826386a22f,katrinarodriguez,30,Male,Guatemala,86,15,71,2924,7568
c84f9332-4716-47e8-9103-38bac2014831,samuelschultz,23,Female,Belize,97,42,55,2231,4753
e084903d-c27c-4ee5-ae4f-604e4c1bdfc9,melissawilliams,65,Female,New Zealand,23,0,23,989,1909
94a99a90-1fdf-4eb3-91b2-300ed7262cc6,solisdominic,45,Female,Lithuania,45,0,45,1035,990
f86d2119-8161-4a2d-8d0c-9a53e08131fc,ocox,48,Female,Kyrgyz Republic,9,9,0,387,531
be0ff1d6-677c-4fdb-8419-25451af045a6,holmeschristopher,43,Other,Nepal,28,1,27,1064,588
46383a9b-cce7-48f2-893d-2a43ecc4817a,vharris,41,Male,Iran,66,38,28,1056,4158
da961cdb-16b9-407c-8818-c140a7dbd1c1,garzakelsey,40,Other,Sudan,71,7,64,2556,2627
15c18446-5cd5-4785-97fd-d87acb5e2044,sheila89,51,Male,Bosnia and Herzegovina,47,19,28,1457,3478
6121f933-11f7-4395-b8b3-45013157b000,tmatthews,23,Other,Paraguay,91,0,91,2184,2912
908f530f-0381-4ee6-a89e-28ff34cf5087,vasquezmichelle,39,Female,Croatia,72,48,24,1152,6192
420c1bab-ea52-4e05-a6a3-c7b51336577d,jacksonbarbara,31,Female,Martinique,23,23,0,690,1909
5a8a4665-3c1e-4adb-9737-8cd009057a8a,howardmcmahon,41,Male,Mali,77,44,33,1617,2079
9a9dec00-4d6a-43c8-942f-88ae99eedd31,cassie97,26,Other,Thailand,98,26,72,3822,6566
ccacbb3f-0254-4c86-9fe3-2ad49284a3a3,shall,38,Other,Estonia,94,5,89,3102,6956
c76d5270-d557-4cbf-853e-0de7e97ed678,peggygiles,35,Female,United Kingdom,55,27,28,1540,1595
42bfd40e-38bf-4dad-a0ce-c8d56400afd7,glasskevin,36,Female,San Marino,64,5,59,960,5440
4ca3c7e6-1291-4124-91a4-a1c1020d2701,kimalex,29,Other,Angola,70,25,45,1330,5740
0d1aaac0-6991-4f47-8048-99299c500f77,tfuentes,35,Male,Paraguay,67,51,16,1541,3216
90b1f097-a979-4dac-b340-9373f4724132,barbararichardson,60,Male,Antarctica (the territory South of 60 deg S),13,12,1,507,1118
9103fd80-5c9f-4c31-8c9e-f3d803a6ffab,qsmith,21,Other,Seychelles,76,24,52,3040,5016
029a6d08-2af7-4f3e-8e5d-c00fda31baef,davisrodney,32,Female,Mauritania,13,9,4,546,1131
f618010c-26e6-4c7f-afb3-3dc65cc7bf8b,csampson,56,Female,Niger,100,30,70,2300,5500
e862c678-3bf0-403e-8d9b-3e0fc6769184,cherylmalone,56,Male,Tuvalu,63,11,52,2079,2772
9fef4f5c-5859-4e1c-8cee-2b4634b7a08b,stephanie95,33,Male,Guatemala,3,0,3,102,276
984d6793-548a-4516-86e9-27b96c10136a,steven78,59,Female,Lesotho,26,9,17,1066,1274
00ef2743-0422-407d-b054-a3436f215787,phillipschristopher,23,Female,Ethiopia,76,22,54,1900,3420
5f7c9fcc-4d9c-4725-9436-5944c287d4ed,jacqueline72,61,Other,Antarctica (the territory South of 60 deg S),30,0,30,1110,1710
54723731-c63b-439f-b981-c79c47a12825,andrea60,63,Other,Guinea-Bissau,73,53,20,2336,3212
8e142365-aa7c-47d2-b996-11deb22b3d0f,christywilliams,38,Female,Zimbabwe,53,12,41,1537,1113
14dc44e2-b664-48ef-8c50-6e4d29aa2606,denise61,51,Female,Wallis and Futuna,74,51,23,2886,6734
2ebaff62-038f-468a-ac4c-75824eaa076d,laurie51,64,Female,Cook Islands,46,3,43,966,3450
d8233ed4-eff4-4e4c-9cae-5a2b4613c427,wilsonvalerie,49,Male,Puerto Rico,90,58,32,3600,4320
b0c050e2-68a8-40fe-a889-a41b65163620,jerrygilbert,20,Other,Spain,3,0,3,126,261
023f7494-ade5-42e0-aeb3-e3cafef41065,ujohnson,58,Other,Palestinian Territory,63,45,18,2331,2268
6790240d-1c6d-4986-8c0b-25a8dff5886b,jameswilliams,36,Male,Andorra,21,1,20,672,924
fad3b402-56c3-47b0-92d9-3fb1bf876fb4,dalton78,23,Other,Tonga,29,12,17,812,2842
57564bd3-f19f-4aec-89e0-56283b47b60e,david95,20,Female,Reunion,99,58,41,2970,7425
0d029547-84cb-4423-9d98-0ad6a77bf436,bryantwilliam,30,Male,Guernsey,81,69,12,3078,2187
d822810c-a3c6-42c1-ba0d-521414bd5882,margaret24,37,Female,Armenia,79,35,44,1343,6004
d8f21006-fcee-484a-af9e-dff867df399e,loganrogers,52,Male,Kiribati,40,33,7,1280,800
244578f7-7c07-4901-9062-6924b563175f,rsmith,31,Female,Ecuador,48,37,11,912,3600
faafee9d-306a-4241-9939-b9d4d904469f,evanstonya,52,Other,Libyan Arab Jamahiriya,100,53,47,4400,9500
a2a43f4e-fbb7-451a-a89d-8b08b6fd9b3e,kristythompson,24,Other,Switzerland,1,1,0,41,65
d9136242-b4aa-4d0d-8309-94f6d526c0a4,brandonhanson,63,Male,Jersey,33,1,32,1254,2706
f6da4657-2daf-4be0-afa7-993e0aba2ea8,swalker,18,Male,Fiji,32,22,10,864,1216
3e390351-6a5f-44de-9c2c-82b9bfe46959,frazierjustin,22,Female,United States Minor Outlying Islands,8,7,1,184,544
4dece2b1-7a34-4ada-9e26-5bf69e36bf9a,rhenry,26,Male,Switzerland,80,71,9,1840,4000
75ff656f-bde3-4586-b88a-52105d64fa74,kevinconner,32,Male,Indonesia,35,11,24,1540,2450
5dc188a7-52f4-4815-a153-f52e0d6c74c2,fwashington,52,Female,Ukraine,90,27,63,3510,3330
4597ce0f-dfd0-4e25-ad52-93422047baf0,katherine70,28,Female,Nauru,20,3,17,800,1740
06a2173a-abd6-4638-b251-529290fdb129,mistybailey,65,Female,Sudan,36,31,5,1008,1224
4eac3946-a056-4dfd-8161-7a37ac420cbf,pwagner,52,Female,Slovakia (Slovak Republic),99,5,94,3069,4851
48ac2865-783c-4ac2-9494-c3d97221016e,timothy35,31,Other,Nauru,28,27,1,924,1876
d138c06f-f545-4c82-8b4b-b331f46c663b,wangeugene,57,Other,Papua New Guinea,80,44,36,3200,7200
2569d873-58a2-4d18-8491-ea99fbe47013,lisa12,22,Other,Lebanon,80,0,80,3200,4800
c91c565c-f33f-45f6-b400-8423eb801cfe,audreywashington,44,Female,San Marino,71,16,55,1562,5822
036385d3-8d98-477d-a199-5aacd6a2ac83,rhonda33,42,Female,American Samoa,20,2,18,800,1180
e90dd0a1-2cb5-4dbf-8677-be267480a7c5,upatel,31,Female,Haiti,40,26,14,1240,2000
87754634-48e0-493e-8917-c1ed677e8a8a,renee46,46,Other,Uzbekistan,21,1,20,882,2079
b37d26ab-9d0f-4d15-828b-efa6764149ef,cynthia92,23,Male,Bosnia and Herzegovina,80,34,46,2240,2640
cfc73ab8-00a0-4b2e-996d-42c8c3c6f04d,jacqueline21,25,Female,Chad,10,2,8,320,410
365ea187-b198-4946-a617-749a91fe1aea,trobinson,19,Female,Peru,8,5,3,272,224
666931cc-0c26-4303-b785-a085274a7e66,usolis,25,Female,Kenya,11,11,0,242,792
a1fed50d-691d-4cd9-a449-f878b4277a2b,klinekenneth,58,Male,Greenland,16,7,9,720,1088
e939dc07-8fa3-4f5a-ad2d-77153b36c509,ortegatimothy,55,Other,Cocos (Keeling) Islands,37,11,26,703,1369
f4159814-d330-4369-85f6-c550e8504faf,schmittrussell,32,Male,Saint Vincent and the Grenadines,24,22,2,696,1128
6c6f87c5-edb8-49d0-863d-f02f7684669e,tammyhamilton,26,Female,Jamaica,39,34,5,1677,2847
a3b36720-be04-4f29-8710-e933ea3d91be,sean42,27,Male,Seychelles,22,1,21,682,528
37817854-81f9-4bde-a3f9-6041687c6a43,herringmichael,55,Male,Lebanon,9,6,3,252,648
4e481c7e-c61e-420e-bc28-918ebdd14812,jtate,35,Other,Bahrain,33,10,23,1353,2541
1cf78540-a3f9-4852-929f-9cfb7666b55a,tmyers,18,Other,Cape Verde,34,21,13,1326,2346
b15db347-1cb2-4246-a744-e818538fb6ec,teresa34,21,Female,Saint Helena,55,12,43,1265,1705
2164c95e-4a70-4a0c-8d77-71c2cb673ef1,kgrant,39,Male,British Virgin Islands,52,11,41,832,1716
831a156a-7d45-441e-8b12-3608ec3d2766,bergpamela,58,Male,Dominica,66,50,16,2112,1584
92658394-7287-476e-a1b9-47d7e805c88c,ncarter,29,Male,British Indian Ocean Territory (Chagos Archipelago),52,3,49,988,5148
30621dcc-db61-4f47-ba6b-0ade08cf8c4d,jonathanreed,31,Other,Antarctica (the territory South of 60 deg S),98,51,47,2450,9408
813640de-4318-48a4-8ff2-15f0a7861e99,martinelizabeth,37,Other,Chile,93,38,55,3999,6510
a0f70bb3-ed80-4177-b4e5-b15332e8ef81,joshua90,25,Male,Lesotho,25,21,4,950,2400
603ef2df-a1a5-4868-9f66-477f0765fe48,janet98,18,Other,Equatorial Guinea,69,59,10,2898,3588
ecb2b514-8ae8-4c5a-bf18-116d73e7aa08,daniel16,58,Other,French Southern Territories,17,6,11,646,1411
b21788d1-ac20-4ff4-bf4f-ecbdbe94845a,patrick74,57,Female,Congo,8,3,5,128,176
865767cd-8973-4bb0-8e6e-ee787c48fb7c,kathleen50,41,Other,India,1,1,0,38,50
baa0ace9-a67a-4d67-9c97-cb4645e80a49,caleb68,30,Female,Jamaica,46,26,20,2070,1656
7bd207ef-6231-450b-894c-c72e1c94fb2c,leahgrant,19,Other,Malta,50,50,0,950,1250
f72cf6a9-cf51-40cb-a861-d5ef5c72904b,john69,46,Other,France,14,3,11,518,910
7e93487e-cdcc-4326-bd51-a720cd9ee8ae,olivia00,40,Female,Costa Rica,75,41,34,1425,6825
16ef8ad9-bcc6-41b0-b4b5-d49c7ecfcb7e,mikaylaanderson,20,Female,Comoros,13,10,3,273,663
2e0fd4b9-c1b6-484b-ad4d-7fd2595789bc,johnsullivan,34,Female,Guam,8,2,6,280,648
1918dd60-001f-4ae5-b500-b4f1f96ce6b8,andreamaldonado,50,Male,Ghana,91,18,73,3822,7007
acb73b05-33b8-4687-8e5e-5ceb188df2ce,bradleyacosta,37,Female,Monaco,92,84,8,3128,8004
8ea6c2cb-f670-49b1-a4e9-fb2ef05f27c6,huntbrady,48,Female,Costa Rica,12,1,11,264,876
74f9dc8d-109d-49d0-ac7a-09a21a65f296,robertbass,52,Male,Portugal,82,3,79,2624,7380
8802e486-c86f-40eb-9f76-5c540edccfa3,carla56,21,Female,Estonia,5,2,3,140,300
d829d664-6256-47e3-befb-4e50ef70d206,sellersrobert,48,Female,Antigua and Barbuda,33,19,14,726,825
e8b5858d-be44-4eb1-95f3-a16ac10a7db6,fordjerry,55,Female,Wallis and Futuna,16,10,6,608,720
880c4a7b-eec1-48ff-8165-ce2f62152ab8,ejohnson,42,Female,Cambodia,86,51,35,1978,7138
88c6b5f1-0855-4d2b-a183-8699aaa8c171,rosechristopher,39,Female,Mauritius,72,15,57,3168,7128
e849d59e-597c-4b77-80ca-b6c9c1a72c0a,brooksjames,50,Other,Liberia,18,14,4,720,684
173aea29-fa42-4be2-ac9c-b2bd1c6a9901,sboyle,30,Male,Greenland,41,38,3,697,2501
d1955de0-baa7-496b-bb82-28b535f0f6ee,rgrant,59,Male,Thailand,72,55,17,2232,1944
52d82df2-5bde-43ab-800e-39dfe8646a4d,martincampos,41,Other,Maldives,51,49,2,918,2601
fee8b549-e38e-4153-b501-67296d3e09a8,stephanieperez,29,Male,Kazakhstan,4,4,0,136,224
d44f2bd2-1d34-4f81-ab35-63a420468a45,llyons,59,Female,Croatia,7,2,5,210,525
2a0b5286-3d25-423c-ba2d-e734b1a18b29,jillian86,31,Female,Zimbabwe,12,10,2,228,948
40db583d-e949-4806-9cf3-f7d6619a5f3d,reynoldsrichard,58,Male,Christmas Island,95,24,71,1710,4560
3e6a9f0f-29fd-4a4d-9941-47f44dbee9fe,fsimon,35,Male,Belgium,64,29,35,2368,3008
5658a8ca-538b-475f-9eba-988b6871f43f,ccampbell,57,Other,Lebanon,55,16,39,1870,5225
4e554234-8cb1-462b-80df-d7e4ea6dbe81,pmorse,29,Male,Yemen,27,19,8,513,1377
b14082c0-2dc6-4872-a347-85960521848c,hamiltonbrian,48,Other,Guatemala,96,96,0,1536,5856
0481a314-b1f2-47d8-8f15-e29f0c348ef6,pattoncalvin,40,Male,Armenia,83,7,76,3569,8051
6b0d9171-95db-4b1a-8c8f-0f6ed923a6b4,zsmith,24,Male,Dominican Republic,92,61,31,3404,6532
0e7151ae-c376-4d58-87fc-e3d34af9ef2e,brookesoto,64,Male,Saint Martin,24,19,5,840,1608
36fdae43-c0a5-47da-a52a-6031ab8eb4ac,dgonzalez,20,Other,Nigeria,55,5,50,2145,4675
b8c88835-6353-4af8-8482-8591fbf14827,hodgesrobert,45,Male,Poland,4,4,0,92,80
9edbaee4-294d-4cc8-852c-f8e66f590fd4,lambsusan,62,Female,Sri Lanka,93,0,93,1674,4185
8fb1f696-693d-4686-bdc0-dbcb8fe6e5c2,cbray,45,Other,Sierra Leone,44,1,43,1672,1628
81cbcf7e-a943-4141-b338-2ba8348edb81,wardgregory,30,Female,Bahamas,38,0,38,1254,2166
28c9e649-14f8-4430-906d-b0ee65daf647,smolina,42,Other,Malaysia,90,4,86,3330,7110
b658f8c0-9072-48ae-8425-03789491c930,elizabeth69,29,Male,Burkina Faso,28,25,3,1120,1204
061fc7bf-3cf1-43ca-abd6-613363f4eeb1,morganbolton,50,Female,Niger,11,1,10,198,902
36b3d482-5cb1-4f2f-8c7b-9dd21ff92869,arielthomas,42,Female,Sudan,91,61,30,3640,6461
d0771a9e-6ad2-43f6-8ba9-40e93fc017c9,felicia29,18,Female,Botswana,40,9,31,1760,2080
441d0810-17e6-4cec-8dce-acfb0bf9cf6c,emilysampson,60,Male,Tanzania,54,47,7,2160,3078
925556bc-8ef8-47a2-853b-46897a278d83,andrea75,27,Male,Greenland,61,2,59,2257,4026
911bf291-5f13-41f6-84a6-116a9d706dce,ryanjessica,59,Male,Western Sahara,82,76,6,3444,2542
564b2e69-2605-46b7-b29e-26115e74ac8f,blakesmith,39,Female,Anguilla,3,0,3,60,135
1998dce5-73ac-4514-8c43-d209d77836b1,daisywilkerson,53,Other,Antarctica (the territory South of 60 deg S),81,1,80,1296,6237
27f18e95-6ca6-4579-871b-bb6ddd7fd982,glenn77,37,Other,Guinea,75,9,66,1425,6375
226fce08-e1ac-4b22-b45c-39bc85bad59e,tforbes,64,Female,Puerto Rico,96,5,91,3360,2592
4d748da5-1d1b-4887-98af-1ce91fafa0d8,austin39,28,Other,New Zealand,59,21,38,1357,2360
fda4754f-46ab-4be9-beb6-b6601a58460c,brooke24,39,Other,Lao People's Democratic Republic,44,16,28,880,1364
168069c8-d79b-4387-b9bc-7b3585e05096,anthony03,53,Female,Jersey,36,24,12,1080,2340
fc761db8-3a6d-42ff-8292-7789e7cd56f8,wgentry,57,Female,Latvia,75,61,14,2700,3075
e18cf4a6-2873-4dd7-8df9-058cc38333b4,lwilliams,30,Other,Saudi Arabia,25,24,1,725,525
f448ca84-b66f-495c-bb52-850350ad2007,bennettrhonda,50,Male,Palau,59,46,13,1475,4130
b8a5da55-d8a1-41c1-ae72-6c1068632ab4,brownmorgan,55,Female,Saint Kitts and Nevis,96,63,33,2976,8640
0c41d6db-a35c-4be3-8b04-89c3e8789a1a,matthew43,45,Female,Thailand,5,3,2,120,275
8b03cc7a-7867-49ca-aa7d-cbf186a7b6fc,anthonytaylor,60,Female,Somalia,3,1,2,126,270
9bec06e2-b7e5-4329-b081-6cd8bfa843aa,crosstroy,47,Male,Pitcairn Islands,12,4,8,336,240
33f0a753-8745-4eb0-9026-afb6902144e6,jamie32,32,Other,United Kingdom,99,1,98,4455,3663
9528cccb-b801-430b-900d-7830b8d9fdd0,richard96,45,Other,Palau,18,8,10,774,720
d051bf9d-7f7a-4e0f-9e49-f59bae91a534,tgarcia,64,Other,Macao,79,45,34,3555,5688
a073ce38-c717-494d-8522-990bc20610cd,gsingh,42,Other,Barbados,61,4,57,1403,2379
89fd8844-b183-4ce6-8ebb-3fe48a3b26f3,pgallagher,20,Male,Mexico,72,17,55,1584,3816
a5d46c22-1bd1-4dde-8a82-450d49ee795d,brobinson,65,Female,Togo,54,16,38,2430,3240
9565cbe1-b8c6-4358-a391-03e2f385809b,ryan97,26,Male,Saint Vincent and the Grenadines,60,48,12,2220,2640
1607d6e5-17d7-4034-8720-feaef7cb143c,brandon91,37,Male,Bangladesh,31,14,17,775,2821
b77ac349-eb49-403b-a9bd-578075b08442,daviesmatthew,48,Other,Antigua and Barbuda,52,23,29,2184,3172
3034b545-0dc3-401b-8e0b-b0a37e297602,raycody,42,Female,Bahrain,24,6,18,648,2280
e2de6cae-1f22-486e-8f88-547608d0d928,xwebb,47,Other,India,69,61,8,1518,6279
2a8a695c-9218-43cc-84b7-6321b109eb8d,churchjames,51,Other,Tuvalu,72,46,26,2520,1440
dae0f20e-6c67-4782-a5ce-28ca69c22aa4,mwheeler,57,Female,Saint Pierre and Miquelon,82,51,31,1394,3936
520fdf71-caee-4f9e-b152-f1108ba88902,tgreen,53,Male,Anguilla,82,54,28,2050,2788
8c063618-cc57-4bf2-bd75-d048c1cac993,nbates,59,Female,Comoros,53,53,0,2014,3074
b2f9a616-8cdd-4309-a0cb-c4d8f473fb80,melanie27,24,Other,Belgium,65,61,4,1495,1495
b542d1fc-2792-4f2b-be72-73b3752eb38c,vazquezbenjamin,63,Male,Tanzania,48,30,18,1056,2400
35c1afe0-b01f-41a1-8662-92c0260713e2,josephpatrick,21,Other,Jamaica,78,56,22,1482,2886
314bec4e-2d65-4b93-b801-ef13e058cde9,sanchezjill,34,Female,Tonga,90,53,37,1890,8550
a626798a-50bd-4fa0-990b-69eaa5538fab,blanchardcraig,55,Other,United States Virgin Islands,48,2,46,720,2736
67f38379-4a55-42f4-8924-5e1bb7223b17,sherri26,39,Male,Costa Rica,70,31,39,2800,6090
d971049c-bff3-4113-b285-e3de27afcbd7,garrettlinda,41,Male,Kuwait,63,61,2,2394,6237
a6ba9fde-3e7c-48bd-a774-fd7e0050e89f,carterrobert,43,Male,Kyrgyz Republic,35,25,10,1015,2030
181dada3-383a-4dfb-aa17-0ab7604cdb4a,djordan,21,Other,Sudan,84,23,61,1260,2604
05cdece3-1081-4622-80d4-dd2b3dc354ce,elizabethmonroe,26,Female,North Macedonia,21,11,10,420,420
9caa01ad-aba8-4fe1-b7f4-63aa92614ef5,santiagorachel,54,Other,Falkland Islands (Malvinas),94,38,56,3196,9306
2bb993a3-8a1c-4036-b374-cf5d482db659,joseph31,30,Other,Lithuania,30,19,11,780,3000
52bd534e-32b8-4ff1-8c45-97713e1693c8,michele85,52,Other,Morocco,14,10,4,434,1190
c376bf95-8557-476e-b33a-568e38e1e449,sgray,65,Female,Mayotte,14,12,2,336,658
c767c01f-f493-4353-855d-560a1c7115f2,ashleylove,53,Male,Brunei Darussalam,73,9,64,1095,4380
f767b218-e62f-4a27-9f16-5ff47d76159a,conleyjillian,53,Other,Sierra Leone,37,26,11,629,1258
